benchmark,closure,referenced,referenced non-empty,read non-empty,used,unused non-empty,present non-empty,exact match,widened,narrowed,optimized away non-empty,dependent,other reasons unused non-empty,polluted,used polluted,unused polluted,used polluted exact match,used polluted widened,used polluted narrowed
"areWeFast:Bounce_nonames_simple","match",4,4,4,1,3,1,0,1,0,2,0,1,2,1,1,0,1,0
"areWeFast:Bounce_nonames_simple","nextRandom",7,7,6,3,4,2,2,1,0,2,4,0,1,1,0,0,1,0
"areWeFast:Bounce_nonames_simple","FUN",8,8,8,4,4,3,2,2,0,1,4,0,0,0,0,0,0,0
"areWeFast:Bounce_nonames_simple","bounce",63,46,28,1,45,27,1,0,0,18,44,1,0,0,0,0,0,0
"areWeFast:Bounce_nonames_simple","lapply",17,13,8,0,13,7,0,0,0,6,10,0,4,0,4,0,0,0
"areWeFast:Bounce_nonames_simple","match.fun",40,3,3,1,2,1,0,1,0,1,1,1,2,1,1,0,1,0
"areWeFast:Bounce_nonames_simple","vector",2,2,2,0,2,2,0,0,0,0,0,2,1,0,1,0,0,0
"areWeFast:Bounce_nonames_simple","verifyResult",2,2,2,1,1,1,1,0,0,0,0,1,0,0,0,0,0,0
"areWeFast:Bounce_nonames_simple","execute",113,70,52,1,69,29,1,0,0,40,63,1,6,0,6,0,0,0
"areWeFast:Bounce_nonames_simple","Sys.time",8,5,4,0,5,4,0,0,0,1,2,2,0,0,0,0,0,0
"areWeFast:Bounce_nonames_simple","stdout",0,0,0,0,0,0,0,0,0,0,0,0,0,0,0,0,0,0
"shootout:binarytrees/binarytrees_naive","match",4,4,4,2,2,1,0,2,0,1,0,1,2,2,0,0,2,0
"shootout:binarytrees/binarytrees_naive","%in%",8,8,8,2,6,3,1,1,0,3,0,3,4,1,3,0,1,0
"shootout:binarytrees/binarytrees_naive","tree",30,8,3,1,7,2,1,0,0,5,6,1,0,0,0,0,0,0
"shootout:binarytrees/binarytrees_naive","tree",30,17,8,3,14,5,3,0,0,9,12,2,2,0,2,0,0,0
"shootout:binarytrees/binarytrees_naive","check",19,8,6,5,3,1,2,3,0,2,2,1,0,0,0,0,0,0
"shootout:binarytrees/binarytrees_naive","check",19,16,12,8,8,4,5,3,0,4,7,1,4,2,2,0,2,0
"shootout:binarytrees/binarytrees_naive","tree",30,17,8,0,17,7,0,0,0,10,14,2,2,0,2,0,0,0
"shootout:binarytrees/binarytrees_naive","tree",30,17,8,2,15,6,1,1,0,9,12,3,10,1,9,0,1,0
"shootout:binarytrees/binarytrees_naive","check",19,16,12,9,7,3,3,6,0,4,7,0,12,7,5,2,5,0
"shootout:binarytrees/binarytrees_naive","stdout",0,0,0,0,0,0,0,0,0,0,0,0,0,0,0,0,0,0
"shootout:binarytrees/binarytrees_naive","tree",30,17,8,0,17,8,0,0,0,9,14,3,10,0,10,0,0,0
"shootout:binarytrees/binarytrees_naive","Sys.time",8,5,4,0,5,4,0,0,0,1,2,2,0,0,0,0,0,0
"shootout:binarytrees/binarytrees_naive","is.logint",9,4,4,0,4,1,0,0,0,3,4,0,0,0,0,0,0,0
"shootout:binarytrees/binarytrees_naive","FUN",6,4,2,0,4,0,0,0,0,4,4,0,0,0,0,0,0,0
"shootout:binarytrees/binarytrees_naive","match.fun",40,3,3,1,2,1,0,1,0,1,1,1,2,1,1,0,1,0
"shootout:binarytrees/binarytrees_naive","binarytrees_naive",159,104,43,20,84,25,13,7,0,59,76,6,24,7,17,2,5,0
"shootout:binarytrees/binarytrees_naive","execute",2,2,1,0,2,1,0,0,0,1,0,1,0,0,0,0,0,0
"shootout:binarytrees/binarytrees_naive","unknown--fromOverride",487,76,72,28,48,31,25,3,0,17,46,2,0,0,0,0,0,0
"shootout:binarytrees/binarytrees_naive","is.vector",2,2,1,0,2,1,0,0,0,1,0,1,0,0,0,0,0,0
"shootout:binarytrees/binarytrees_naive","chkDots",15,1,1,1,0,0,1,0,0,0,0,0,0,0,0,0,0,0
"shootout:binarytrees/binarytrees_naive","vapply",17,9,7,0,9,6,0,0,0,3,6,1,0,0,0,0,0,0
"shootout:binarytrees/binarytrees_naive","mostattributes<-",106,3,3,1,2,2,1,0,0,0,0,2,0,0,0,0,0,0
"shootout:knucleotide/knucleotide","match",4,4,4,2,2,1,0,2,0,1,0,1,2,2,0,0,2,0
"shootout:knucleotide/knucleotide","%in%",8,8,8,2,6,3,1,1,0,3,0,3,4,1,3,0,1,0
"shootout:knucleotide/knucleotide",".deparseOpts",83,30,19,10,20,8,8,2,0,12,14,2,2,0,2,0,0,0
"shootout:knucleotide/knucleotide","mode",27,21,14,4,17,8,1,3,0,9,15,0,2,1,1,0,1,0
"shootout:knucleotide/knucleotide","substr",13,7,7,2,5,3,2,0,0,2,4,1,0,0,0,0,0,0
"shootout:knucleotide/knucleotide","inherits",3,3,3,0,3,2,0,0,0,1,0,2,1,0,1,0,0,0
"shootout:knucleotide/knucleotide","identical",8,8,8,0,8,2,0,0,0,6,8,0,0,0,0,0,0,0
"shootout:knucleotide/knucleotide","assign",6,6,4,0,6,4,0,0,0,2,3,3,0,0,0,0,0,0
"shootout:knucleotide/knucleotide","FUN",3,3,1,1,2,0,1,0,0,2,0,0,0,0,0,0,0,0
"shootout:knucleotide/knucleotide","get",6,6,4,1,5,3,0,1,0,2,4,1,0,0,0,0,0,0
"shootout:knucleotide/knucleotide","match.fun",40,3,3,1,2,1,0,1,0,1,1,1,2,1,1,0,1,0
"shootout:knucleotide/knucleotide","is.vector",2,2,1,1,1,0,0,1,0,1,0,0,1,1,0,0,1,0
"shootout:knucleotide/knucleotide","lapply",17,13,8,0,13,7,0,0,0,6,8,1,8,0,8,0,0,0
"shootout:knucleotide/knucleotide","isFALSE",11,8,7,1,7,1,1,0,0,6,6,0,0,0,0,0,0,0
"shootout:knucleotide/knucleotide","unlist",27,5,5,0,5,5,0,0,0,0,5,0,2,0,2,0,0,0
"shootout:knucleotide/knucleotide","eval",8,6,3,1,5,2,0,1,0,3,5,0,1,1,0,0,1,0
"shootout:knucleotide/knucleotide","stdout",0,0,0,0,0,0,0,0,0,0,0,0,0,0,0,0,0,0
"shootout:knucleotide/knucleotide","assign",6,6,4,1,5,3,0,1,0,2,3,2,0,0,0,0,0,0
"shootout:knucleotide/knucleotide","gen_freq",95,54,22,9,45,9,7,2,0,36,38,2,5,0,5,0,0,0
"shootout:knucleotide/knucleotide","exists",8,6,4,1,5,3,0,1,0,2,4,1,0,0,0,0,0,0
"shootout:knucleotide/knucleotide","sapply",32,24,19,6,18,10,4,2,0,8,14,2,0,0,0,0,0,0
"shootout:knucleotide/knucleotide","environment",1,1,1,0,1,0,0,0,0,1,0,0,0,0,0,0,0,0
"shootout:knucleotide/knucleotide","parent.frame",1,1,1,0,1,0,0,0,0,1,0,0,0,0,0,0,0,0
"shootout:knucleotide/knucleotide","ls",48,13,7,2,11,4,1,1,0,7,7,1,1,0,1,0,0,0
"shootout:knucleotide/knucleotide","tryCatch",53,26,17,7,19,7,3,4,0,12,16,1,0,0,0,0,0,0
"shootout:knucleotide/knucleotide","tryCatchOne",30,4,0,0,4,0,0,0,0,4,2,0,0,0,0,0,0,0
"shootout:knucleotide/knucleotide","environment",1,1,1,0,1,0,0,0,0,1,0,0,0,0,0,0,0,0
"shootout:knucleotide/knucleotide","doTryCatch",7,6,6,0,6,5,0,0,0,1,3,3,0,0,0,0,0,0
"shootout:knucleotide/knucleotide","environment",1,1,1,0,1,0,0,0,0,1,0,0,0,0,0,0,0,0
"shootout:knucleotide/knucleotide","simplify2array",151,23,20,8,15,8,7,1,0,7,15,0,2,0,2,0,0,0
"shootout:knucleotide/knucleotide","unknown--fromConstant",2,2,2,1,1,1,0,1,0,0,0,1,0,0,0,0,0,0
"shootout:knucleotide/knucleotide","unique",1,0,0,0,0,0,0,0,0,0,0,0,0,0,0,0,0,0
"shootout:knucleotide/knucleotide","tolower",7,3,3,0,3,3,0,0,0,0,2,1,0,0,0,0,0,0
"shootout:knucleotide/knucleotide","%in%",8,8,8,3,5,3,1,2,0,2,0,3,4,2,2,0,2,0
"shootout:knucleotide/knucleotide","find_seq",20,19,14,5,14,5,2,3,0,9,8,2,4,2,2,0,2,0
"shootout:knucleotide/knucleotide","gen_freq",95,54,19,9,45,9,7,2,0,36,38,2,5,0,5,0,0,0
"shootout:knucleotide/knucleotide","nchar",4,4,4,1,3,0,0,1,0,3,3,0,0,0,0,0,0,0
"shootout:knucleotide/knucleotide","getOption",5,4,4,0,4,3,0,0,0,1,3,1,0,0,0,0,0,0
"shootout:knucleotide/knucleotide","vapply",17,9,7,0,9,6,0,0,0,3,6,1,3,0,3,0,0,0
"shootout:knucleotide/knucleotide","logical",1,1,1,0,1,1,0,0,0,0,0,1,0,0,0,0,0,0
"shootout:knucleotide/knucleotide","FUN",19,14,12,5,9,4,4,1,0,5,4,2,3,0,3,0,0,0
"shootout:knucleotide/knucleotide","sort_seq",48,31,9,1,30,5,1,0,0,25,25,2,2,0,2,0,0,0
"shootout:knucleotide/knucleotide","gen_freq",95,54,19,8,46,9,6,2,0,37,39,2,5,0,5,0,0,0
"shootout:knucleotide/knucleotide","formals",10,3,3,1,2,2,0,1,0,0,1,1,0,0,0,0,0,0
"shootout:knucleotide/knucleotide","match.arg",69,27,17,3,24,8,2,1,0,16,20,0,2,0,2,0,0,0
"shootout:knucleotide/knucleotide","sys.function",1,1,1,1,0,0,1,0,0,0,0,0,0,0,0,0,0,0
"shootout:knucleotide/knucleotide","sys.parent",1,1,1,0,1,0,0,0,0,1,0,0,0,0,0,0,0,0
"shootout:knucleotide/knucleotide","sys.frame",1,1,1,0,1,1,0,0,0,0,0,1,0,0,0,0,0,0
"shootout:knucleotide/knucleotide","Sys.time",8,5,4,0,5,4,0,0,0,1,2,2,0,0,0,0,0,0
"shootout:knucleotide/knucleotide","file",8,8,6,0,8,5,0,0,0,3,8,0,0,0,0,0,0,0
"shootout:knucleotide/knucleotide","close",1,0,0,0,0,0,0,0,0,0,0,0,0,0,0,0,0,0
"shootout:knucleotide/knucleotide","strsplit",7,6,3,2,4,1,0,2,0,3,4,0,0,0,0,0,0,0
"shootout:knucleotide/knucleotide","execute",8,8,4,0,8,4,0,0,0,4,2,3,1,0,1,0,0,0
"shootout:knucleotide/knucleotide","close",1,0,0,0,0,0,0,0,0,0,0,0,0,0,0,0,0,0
"shootout:knucleotide/knucleotide","knucleotide",195,153,98,37,116,39,21,16,0,77,107,6,3,1,2,0,1,0
"shootout:knucleotide/knucleotide","scan",55,30,27,2,28,23,1,1,0,5,24,2,1,0,1,0,0,0
"shootout:knucleotide/knucleotide","gen_freq",95,54,22,9,45,9,7,2,0,36,38,2,5,0,5,0,0,0
"shootout:knucleotide/knucleotide","get",6,6,4,0,6,4,0,0,0,2,5,1,0,0,0,0,0,0
"shootout:knucleotide/knucleotide","getOption",5,4,4,0,4,3,0,0,0,1,3,1,0,0,0,0,0,0
"shootout:fasta/fasta_naive_2","match",4,4,4,2,2,1,0,2,0,1,0,1,2,2,0,0,2,0
"shootout:fasta/fasta_naive_2","%in%",8,8,8,2,6,3,1,1,0,3,0,3,4,1,3,0,1,0
"shootout:fasta/fasta_naive_2",".deparseOpts",83,30,19,10,20,8,8,2,0,12,14,2,2,0,2,0,0,0
"shootout:fasta/fasta_naive_2","mode",27,21,14,4,17,8,1,3,0,9,15,0,2,1,1,0,1,0
"shootout:fasta/fasta_naive_2","withVisible",3,1,1,0,1,1,0,0,0,0,0,1,0,0,0,0,0,0
"shootout:fasta/fasta_naive_2","eval",8,6,3,0,6,3,0,0,0,3,5,1,0,0,0,0,0,0
"shootout:fasta/fasta_naive_2",".deparseOpts",83,30,19,10,20,8,8,2,0,12,14,2,2,0,2,0,0,0
"shootout:fasta/fasta_naive_2","deparse",11,11,6,2,9,4,1,1,0,5,8,0,0,0,0,0,0,0
"shootout:fasta/fasta_naive_2","stdout",0,0,0,0,0,0,0,0,0,0,0,0,0,0,0,0,0,0
"shootout:fasta/fasta_naive_2","myrandom",8,8,8,1,7,6,1,0,0,1,7,0,0,0,0,0,0,0
"shootout:fasta/fasta_naive_2","character",1,1,1,0,1,1,0,0,0,0,0,1,0,0,0,0,0,0
"shootout:fasta/fasta_naive_2","random_fasta",144,78,71,16,62,31,9,7,0,31,58,2,7,1,6,0,1,0
"shootout:fasta/fasta_naive_2","Sys.time",8,5,4,0,5,4,0,0,0,1,2,2,0,0,0,0,0,0
"shootout:fasta/fasta_naive_2","strsplit",7,6,3,2,4,1,0,2,0,3,4,0,0,0,0,0,0,0
"shootout:fasta/fasta_naive_2","repeat_fasta",158,106,84,22,84,28,14,8,0,56,80,2,2,0,2,0,0,0
"shootout:fasta/fasta_naive_2","fasta_naive_2",43,26,5,2,24,3,1,1,0,21,18,1,2,0,2,0,0,0
"shootout:fasta/fasta_naive_2","execute",2,2,1,0,2,1,0,0,0,1,0,1,0,0,0,0,0,0
"shootout:fannkuch/fannkuchredux","match",4,4,4,1,3,1,0,1,0,2,0,1,2,1,1,0,1,0
"shootout:fannkuch/fannkuchredux","rev.default",13,7,7,2,5,2,2,0,0,3,5,0,0,0,0,0,0,0
"shootout:fannkuch/fannkuchredux","stdout",0,0,0,0,0,0,0,0,0,0,0,0,0,0,0,0,0,0
"shootout:fannkuch/fannkuchredux","Sys.time",8,5,4,0,5,4,0,0,0,1,2,2,0,0,0,0,0,0
"shootout:fannkuch/fannkuchredux","execute",39,22,12,0,22,6,0,0,0,16,16,3,2,0,2,0,0,0
"shootout:fannkuch/fannkuchredux","fannkuch",187,146,138,2,144,51,2,0,0,93,140,2,2,0,2,0,0,0
"shootout:pidigits/pidigits","match",4,4,4,2,2,1,0,2,0,1,0,1,2,2,0,0,2,0
"shootout:pidigits/pidigits","%in%",8,8,8,2,6,3,1,1,0,3,0,3,4,1,3,0,1,0
"shootout:pidigits/pidigits",".deparseOpts",83,30,19,10,20,8,8,2,0,12,14,2,2,0,2,0,0,0
"shootout:pidigits/pidigits","mode",27,21,14,4,17,8,1,3,0,9,15,0,2,1,1,0,1,0
"shootout:pidigits/pidigits","withVisible",3,1,1,0,1,1,0,0,0,0,0,1,0,0,0,0,0,0
"shootout:pidigits/pidigits","eval",8,6,3,0,6,3,0,0,0,3,5,1,0,0,0,0,0,0
"shootout:pidigits/pidigits",".deparseOpts",83,30,19,10,20,8,8,2,0,12,14,2,2,0,2,0,0,0
"shootout:pidigits/pidigits","deparse",11,11,6,2,9,4,1,1,0,5,8,0,0,0,0,0,0,0
"shootout:pidigits/pidigits","%in%",8,8,8,3,5,2,1,2,0,3,0,2,4,2,2,0,2,0
"shootout:pidigits/pidigits","mode",27,21,14,5,16,8,1,4,0,8,14,0,2,2,0,0,2,0
"shootout:pidigits/pidigits","substr",13,7,7,4,3,3,2,2,0,0,2,1,2,2,0,0,2,0
"shootout:pidigits/pidigits","nchar",4,4,4,0,4,1,0,0,0,3,4,0,0,0,0,0,0,0
"shootout:pidigits/pidigits","substr",13,9,9,5,4,4,2,3,0,0,2,2,3,2,1,0,2,0
"shootout:pidigits/pidigits","match.fun",40,3,3,1,2,1,0,1,0,1,1,1,0,0,0,0,0,0
"shootout:pidigits/pidigits","unknown--fromConstant",9,5,5,2,3,2,2,0,0,1,2,1,3,0,3,0,0,0
"shootout:pidigits/pidigits","is.logint",9,4,4,0,4,1,0,0,0,3,4,0,0,0,0,0,0,0
"shootout:pidigits/pidigits","integer",1,1,1,1,0,0,1,0,0,0,0,0,0,0,0,0,0,0
"shootout:pidigits/pidigits","unknown--fromConstant",7,7,7,4,3,1,2,2,0,2,2,1,4,2,2,0,2,0
"shootout:pidigits/pidigits","cmp_mag",54,28,24,11,17,5,6,5,0,12,16,1,10,5,5,0,5,0
"shootout:pidigits/pidigits","unknown--fromConstant",56,24,22,4,20,5,4,0,0,15,20,0,0,0,0,0,0,0
"shootout:pidigits/pidigits","unknown--fromConstant",61,20,16,13,7,3,4,9,0,4,6,0,14,9,5,0,9,0
"shootout:pidigits/pidigits","integer",1,1,1,0,1,1,0,0,0,0,0,1,0,0,0,0,0,0
"shootout:pidigits/pidigits","mul",93,49,33,16,33,11,13,3,0,22,31,1,16,3,13,0,3,0
"shootout:pidigits/pidigits","seq",487,67,65,24,43,27,21,3,0,16,42,1,0,0,0,0,0,0
"shootout:pidigits/pidigits","multiply_mag",132,41,41,22,19,7,16,6,0,12,17,1,10,6,4,0,6,0
"shootout:pidigits/pidigits","chkDots",15,1,1,1,0,0,1,0,0,0,0,0,0,0,0,0,0,0
"shootout:pidigits/pidigits","cmp",30,15,11,8,7,3,3,5,0,4,7,0,12,5,7,0,5,0
"shootout:pidigits/pidigits","sapply",32,24,19,6,18,10,4,2,0,8,14,2,0,0,0,0,0,0
"shootout:pidigits/pidigits","str_to_mag",59,34,29,11,23,11,8,3,0,12,17,3,4,2,2,0,2,0
"shootout:pidigits/pidigits","strip_leading_zeros",54,27,19,9,18,7,4,5,0,11,16,2,7,2,5,0,2,0
"shootout:pidigits/pidigits","lapply",17,13,8,0,13,7,0,0,0,6,8,1,6,0,6,0,0,0
"shootout:pidigits/pidigits","unlist",27,5,5,0,5,5,0,0,0,0,5,0,2,0,2,0,0,0
"shootout:pidigits/pidigits","simplify2array",151,23,20,8,15,8,7,1,0,7,15,0,2,0,2,0,0,0
"shootout:pidigits/pidigits","unknown--fromConstant",2,2,2,1,1,1,0,1,0,0,0,1,0,0,0,0,0,0
"shootout:pidigits/pidigits","unique",1,0,0,0,0,0,0,0,0,0,0,0,0,0,0,0,0,0
"shootout:pidigits/pidigits","add_mag",139,53,53,29,24,11,21,8,0,13,23,0,8,8,0,0,8,0
"shootout:pidigits/pidigits","unknown--fromConstant",61,46,27,19,27,6,10,9,0,21,26,0,14,9,5,0,9,0
"shootout:pidigits/pidigits","unknown--fromConstant",7,7,5,4,3,1,2,2,0,2,2,1,4,2,2,0,2,0
"shootout:pidigits/pidigits","unknown--fromConstant",56,24,23,7,17,5,7,0,0,12,17,0,0,0,0,0,0,0
"shootout:pidigits/pidigits","sub_mag",106,39,39,18,21,10,14,4,0,11,20,0,3,3,0,0,3,0
"shootout:pidigits/pidigits","unknown--fromConstant",56,24,23,2,22,9,2,0,0,13,22,0,6,0,6,0,0,0
"shootout:pidigits/pidigits","unknown--fromConstant",9,5,5,1,4,3,1,0,0,1,3,1,4,0,4,0,0,0
"shootout:pidigits/pidigits","mul",30,18,9,7,11,2,5,2,0,9,10,0,13,3,10,1,2,0
"shootout:pidigits/pidigits","sub_mag",106,49,49,22,27,14,16,5,1,13,26,0,8,7,1,3,4,0
"shootout:pidigits/pidigits","sub",62,38,23,15,23,6,11,4,0,17,23,0,8,4,4,0,4,0
"shootout:pidigits/pidigits","lt",34,19,13,9,10,3,4,5,0,7,9,1,14,5,9,0,5,0
"shootout:pidigits/pidigits","multiply_mag",132,97,97,45,52,25,37,8,0,27,50,1,13,8,5,0,8,0
"shootout:pidigits/pidigits","unknown--fromConstant",61,46,27,18,28,7,9,9,0,21,28,0,18,11,7,2,9,0
"shootout:pidigits/pidigits","div2",105,26,25,6,20,10,4,2,0,10,18,1,4,0,4,0,0,0
"shootout:pidigits/pidigits","add_mag",139,77,77,19,58,22,9,10,0,36,57,0,11,8,3,0,8,0
"shootout:pidigits/pidigits","le",34,19,13,9,10,3,4,5,0,7,9,1,12,5,7,0,5,0
"shootout:pidigits/pidigits","unknown--fromConstant",7,7,7,3,4,2,2,1,0,2,3,1,4,1,3,0,1,0
"shootout:pidigits/pidigits","log10_mag",14,8,8,4,4,4,4,0,0,0,4,0,1,1,0,1,0,0
"shootout:pidigits/pidigits","cmp_elem",7,7,7,4,3,1,2,2,0,2,2,1,4,2,2,0,2,0
"shootout:pidigits/pidigits","cmp_mag",54,36,29,13,23,6,8,5,0,17,22,1,10,5,5,0,5,0
"shootout:pidigits/pidigits","ge",34,19,13,9,10,3,4,5,0,7,9,1,12,5,7,0,5,0
"shootout:pidigits/pidigits","add_mag",139,86,86,29,57,25,19,10,0,32,56,0,11,10,1,2,8,0
"shootout:pidigits/pidigits","bigint_pow10",25,12,11,2,10,6,2,0,0,4,9,1,0,0,0,0,0,0
"shootout:pidigits/pidigits","unknown--fromConstant",61,46,27,18,28,7,8,10,0,21,28,0,23,12,11,2,10,0
"shootout:pidigits/pidigits","rep.int",2,2,2,2,0,0,2,0,0,0,0,0,0,0,0,0,0,0
"shootout:pidigits/pidigits","sub",62,38,23,13,25,8,9,4,0,17,25,0,16,5,11,1,4,0
"shootout:pidigits/pidigits","multiply_mag",132,97,97,47,50,24,37,10,0,26,48,1,16,10,6,0,10,0
"shootout:pidigits/pidigits","seq",489,87,82,29,58,40,25,4,0,18,57,1,2,2,0,2,0,0
"shootout:pidigits/pidigits","gt",34,19,13,9,10,3,4,5,0,7,9,1,12,5,7,0,5,0
"shootout:pidigits/pidigits","mul",30,18,9,9,9,0,5,4,0,9,8,0,13,5,8,1,4,0
"shootout:pidigits/pidigits","cmp",30,15,11,9,6,2,3,6,0,4,6,0,12,6,6,0,6,0
"shootout:pidigits/pidigits","unknown--fromConstant",61,46,27,15,31,7,8,7,0,24,31,0,23,9,14,2,7,0
"shootout:pidigits/pidigits","unknown--fromConstant",7,7,5,4,3,1,2,2,0,2,2,1,4,2,2,0,2,0
"shootout:pidigits/pidigits","mul",30,18,9,9,9,0,5,4,0,9,8,0,13,5,8,1,4,0
"shootout:pidigits/pidigits","unknown--fromConstant",273,153,106,41,112,42,32,9,0,70,105,5,32,11,21,3,8,0
"shootout:pidigits/pidigits","div",36,23,11,4,19,5,3,1,0,14,18,1,6,1,5,0,1,0
"shootout:pidigits/pidigits","sub",62,38,23,13,25,8,9,4,0,17,25,0,16,5,11,1,4,0
"shootout:pidigits/pidigits","add_mag",139,99,99,35,64,31,24,11,0,33,63,0,11,10,1,2,8,0
"shootout:pidigits/pidigits","sub_mag",106,60,60,25,35,20,19,6,0,15,34,0,9,7,2,3,4,0
"shootout:pidigits/pidigits","to_int",40,18,18,10,8,5,6,4,0,3,7,1,6,4,2,0,4,0
"shootout:pidigits/pidigits","add_mag",139,99,99,35,64,31,23,12,0,33,63,0,11,10,1,2,8,0
"shootout:pidigits/pidigits","nchar",4,4,4,1,3,0,0,1,0,3,3,0,0,0,0,0,0,0
"shootout:pidigits/pidigits","stdout",0,0,0,0,0,0,0,0,0,0,0,0,0,0,0,0,0,0
"shootout:pidigits/pidigits","zeropad",13,8,2,0,8,2,0,0,0,6,3,1,1,0,1,0,0,0
"shootout:pidigits/pidigits","Sys.time",8,5,4,0,5,4,0,0,0,1,2,2,0,0,0,0,0,0
"shootout:pidigits/pidigits","execute",2,2,1,0,2,1,0,0,0,1,0,1,0,0,0,0,0,0
"shootout:pidigits/pidigits","pidigits",463,337,191,95,242,84,62,33,0,158,232,7,80,34,46,5,29,0
"shootout:pidigits/pidigits","str_to_mag",59,34,29,11,23,11,8,3,0,12,17,3,4,2,2,0,2,0
"shootout:pidigits/pidigits","bigint",39,23,19,9,14,6,6,3,0,8,11,2,9,3,6,1,2,0
"shootout:pidigits/pidigits","bigint",39,23,18,12,11,6,6,6,0,5,9,2,9,4,5,1,3,0
"shootout:pidigits/pidigits","cmp",30,15,11,9,6,2,3,6,0,4,6,0,12,6,6,0,6,0
"shootout:pidigits/pidigits","cmp",30,15,11,9,6,2,3,6,0,4,6,0,12,6,6,0,6,0
"shootout:pidigits/pidigits","unknown--fromConstant",7,7,5,4,3,1,2,2,0,2,2,1,4,2,2,0,2,0
"shootout:pidigits/pidigits","div",36,23,9,4,19,5,3,1,0,14,18,1,6,1,5,0,1,0
"shootout:pidigits/pidigits","sub",62,38,23,13,25,8,9,4,0,17,25,0,16,5,11,1,4,0
"shootout:pidigits/pidigits","to_int",40,18,18,14,4,4,8,6,0,0,3,1,6,6,0,0,6,0
"shootout:pidigits/pidigits","bigint",39,23,19,9,14,6,5,4,0,8,11,2,9,3,6,1,2,0
"shootout:fannkuch/fannkuchredux_naive","match",4,4,4,1,3,1,0,1,0,2,0,1,2,1,1,0,1,0
"shootout:fannkuch/fannkuchredux_naive","stdout",0,0,0,0,0,0,0,0,0,0,0,0,0,0,0,0,0,0
"shootout:fannkuch/fannkuchredux_naive","Sys.time",8,5,4,0,5,4,0,0,0,1,2,2,0,0,0,0,0,0
"shootout:fannkuch/fannkuchredux_naive","execute",39,22,13,0,22,6,0,0,0,16,16,3,2,0,2,0,0,0
"shootout:fannkuch/fannkuchredux_naive","fannkuch",193,133,123,2,131,41,2,0,0,90,127,2,2,0,2,0,0,0
"areWeFast:Mandelbrot","match",4,4,4,2,2,1,0,2,0,1,0,1,2,2,0,0,2,0
"areWeFast:Mandelbrot","%in%",8,8,8,2,6,3,1,1,0,3,0,3,4,1,3,0,1,0
"areWeFast:Mandelbrot",".deparseOpts",83,30,19,10,20,8,8,2,0,12,14,2,2,0,2,0,0,0
"areWeFast:Mandelbrot","mode",27,21,14,4,17,8,1,3,0,9,15,0,2,1,1,0,1,0
"areWeFast:Mandelbrot","bitwShiftL",2,2,2,0,2,2,0,0,0,0,2,0,0,0,0,0,0,0
"areWeFast:Mandelbrot","bitwXor",2,2,2,0,2,2,0,0,0,0,0,2,1,0,1,0,0,0
"areWeFast:Mandelbrot","bitwShiftL",2,2,2,1,1,1,1,0,0,0,1,0,0,0,0,0,0,0
"areWeFast:Mandelbrot","bitwXor",2,2,2,0,2,2,0,0,0,0,2,0,2,0,2,0,0,0
"areWeFast:Mandelbrot","Sys.time",8,5,4,0,5,4,0,0,0,1,2,2,0,0,0,0,0,0
"areWeFast:Mandelbrot","mandelbrot",99,99,96,1,98,42,0,1,0,56,97,0,3,0,3,0,0,0
"areWeFast:Mandelbrot","stdout",0,0,0,0,0,0,0,0,0,0,0,0,0,0,0,0,0,0
"areWeFast:Mandelbrot","verifyResult",20,4,4,1,3,3,1,0,0,0,3,0,0,0,0,0,0,0
"areWeFast:Mandelbrot","execute",2,2,1,1,1,0,1,0,0,1,1,0,0,0,0,0,0,0
"areWeFast:Mandelbrot","mandelbrot",99,99,55,2,97,41,1,1,0,56,96,0,3,0,3,0,0,0
"RealThing:flexclust_no_s4","match",4,4,4,2,2,1,0,2,0,1,0,1,2,2,0,0,2,0
"RealThing:flexclust_no_s4","%in%",8,8,8,2,6,3,1,1,0,3,0,3,4,1,3,0,1,0
"RealThing:flexclust_no_s4",".deparseOpts",83,30,19,10,20,8,8,2,0,12,14,2,2,0,2,0,0,0
"RealThing:flexclust_no_s4","mode",27,21,14,4,17,8,1,3,0,9,15,0,2,1,1,0,1,0
"RealThing:flexclust_no_s4","withVisible",3,1,1,0,1,1,0,0,0,0,0,1,0,0,0,0,0,0
"RealThing:flexclust_no_s4","unknown--fromConstant",8,6,3,0,6,3,0,0,0,3,5,1,0,0,0,0,0,0
"RealThing:flexclust_no_s4",".deparseOpts",83,30,19,10,20,8,8,2,0,12,14,2,2,0,2,0,0,0
"RealThing:flexclust_no_s4","deparse",11,11,6,2,9,4,1,1,0,5,8,0,0,0,0,0,0,0
"RealThing:flexclust_no_s4","pmatch",8,6,6,1,5,4,0,1,0,1,3,1,0,0,0,0,0,0
"RealThing:flexclust_no_s4","%in%",8,8,8,3,5,3,1,2,0,2,0,3,4,2,2,0,2,0
"RealThing:flexclust_no_s4","unknown--fromConstant",8,6,3,1,5,2,0,1,0,3,5,0,1,1,0,0,1,0
"RealThing:flexclust_no_s4","identical",8,8,8,0,8,2,0,0,0,6,8,0,2,0,2,0,0,0
"RealThing:flexclust_no_s4","match.arg",77,53,42,15,38,16,10,5,0,22,32,0,5,0,5,0,0,0
"RealThing:flexclust_no_s4","formals",10,3,3,1,2,2,0,1,0,0,1,1,0,0,0,0,0,0
"RealThing:flexclust_no_s4","sys.function",1,1,1,1,0,0,1,0,0,0,0,0,0,0,0,0,0,0
"RealThing:flexclust_no_s4","sys.parent",1,1,1,0,1,0,0,0,0,1,0,0,0,0,0,0,0,0
"RealThing:flexclust_no_s4","sys.frame",1,1,1,0,1,1,0,0,0,0,0,1,0,0,0,0,0,0
"RealThing:flexclust_no_s4","mode",27,21,14,5,16,8,1,4,0,8,14,0,2,2,0,0,2,0
"RealThing:flexclust_no_s4","inherits",3,3,3,0,3,2,0,0,0,1,0,2,1,0,1,0,0,0
"RealThing:flexclust_no_s4","unknown--fromConstant",4,3,3,2,1,1,2,0,0,0,0,1,0,0,0,0,0,0
"RealThing:flexclust_no_s4","match",4,4,4,1,3,1,0,1,0,2,0,1,2,1,1,0,1,0
"RealThing:flexclust_no_s4","unknown--fromConstant",4,3,3,2,1,1,2,0,0,0,0,1,0,0,0,0,0,0
"RealThing:flexclust_no_s4","colSums",95,45,42,21,24,16,18,3,0,8,19,2,1,0,1,0,0,0
"RealThing:flexclust_no_s4","t",1,0,0,0,0,0,0,0,0,0,0,0,0,0,0,0,0,0
"RealThing:flexclust_no_s4","formals",10,3,3,0,3,3,0,0,0,0,2,1,0,0,0,0,0,0
"RealThing:flexclust_no_s4","is.data.frame",5,5,4,1,4,1,1,0,0,3,0,1,1,0,1,0,0,0
"RealThing:flexclust_no_s4","matrix",13,9,8,0,9,6,0,0,0,3,8,1,3,0,3,0,0,0
"RealThing:flexclust_no_s4","colMeans",95,45,42,19,26,18,16,3,0,8,21,2,1,0,1,0,0,0
"RealThing:flexclust_no_s4","distEuclidean",95,52,32,11,41,12,11,0,0,29,37,3,3,0,3,0,0,0
"RealThing:flexclust_no_s4","unknown--fromConstant",4,3,3,1,2,2,1,0,0,0,0,2,0,0,0,0,0,0
"RealThing:flexclust_no_s4","as.matrix",1,0,0,0,0,0,0,0,0,0,0,0,0,0,0,0,0,0
"RealThing:flexclust_no_s4","max.col",24,15,10,4,11,3,2,2,0,8,6,1,0,0,0,0,0,0
"RealThing:flexclust_no_s4","unknown--fromConstant",8,7,3,1,6,2,0,1,0,4,6,0,1,1,0,0,1,0
"RealThing:flexclust_no_s4","match.arg",77,53,42,15,38,16,10,5,0,22,32,0,5,0,5,0,0,0
"RealThing:flexclust_no_s4","as.matrix",1,0,0,0,0,0,0,0,0,0,0,0,0,0,0,0,0,0
"RealThing:flexclust_no_s4","parent.frame",1,1,1,0,1,0,0,0,0,1,0,0,0,0,0,0,0,0
"RealThing:flexclust_no_s4","kmeansAllcent",70,35,26,12,23,9,11,1,0,14,22,0,3,0,3,0,0,0
"RealThing:flexclust_no_s4","match.arg",77,53,42,15,38,16,10,5,0,22,32,0,5,0,5,0,0,0
"RealThing:flexclust_no_s4","match.fun",40,3,3,1,2,1,0,1,0,1,1,1,2,1,1,0,1,0
"RealThing:flexclust_no_s4","is.vector",2,2,1,0,2,1,0,0,0,1,0,1,0,0,0,0,0,0
"RealThing:flexclust_no_s4","vapply",17,9,7,0,9,6,0,0,0,3,6,1,2,0,2,0,0,0
"RealThing:flexclust_no_s4","logical",1,1,1,0,1,1,0,0,0,0,0,1,0,0,0,0,0,0
"RealThing:flexclust_no_s4","is.factor",5,5,4,1,4,1,1,0,0,3,0,1,2,0,2,0,0,0
"RealThing:flexclust_no_s4","FUN",14,5,5,1,4,2,1,0,0,2,4,0,0,0,0,0,0,0
"RealThing:flexclust_no_s4","rep_len",2,2,2,2,0,0,2,0,0,0,0,0,0,0,0,0,0,0
"RealThing:flexclust_no_s4","sort.list",84,34,28,13,21,11,6,7,0,10,21,0,0,0,0,0,0,0
"RealThing:flexclust_no_s4","",9,5,5,0,5,5,0,0,0,0,2,3,0,0,0,0,0,0
"RealThing:flexclust_no_s4","which",12,3,2,2,1,0,2,0,0,1,0,0,0,0,0,0,0,0
"RealThing:flexclust_no_s4","FUN",16,7,6,2,5,2,2,0,0,3,1,2,0,0,0,0,0,0
"RealThing:flexclust_no_s4","FUN",16,7,6,2,5,2,2,0,0,3,1,2,0,0,0,0,0,0
"RealThing:flexclust_no_s4","inherits",3,3,3,0,3,3,0,0,0,0,0,3,1,0,1,0,0,0
"RealThing:flexclust_no_s4","%in%",8,8,8,3,5,3,3,0,0,2,1,2,6,3,3,3,0,0
"RealThing:flexclust_no_s4",".deparseOpts",87,34,32,11,23,11,8,3,0,12,15,2,6,1,5,1,0,0
"RealThing:flexclust_no_s4","lengths",2,2,2,0,2,1,0,0,0,1,0,1,0,0,0,0,0,0
"RealThing:flexclust_no_s4","unlist",27,5,5,0,5,5,0,0,0,0,5,0,2,0,2,0,0,0
"RealThing:flexclust_no_s4","lapply",17,13,8,0,13,7,0,0,0,6,10,0,4,0,4,0,0,0
"RealThing:flexclust_no_s4","FUN",1,0,0,0,0,0,0,0,0,0,0,0,0,0,0,0,0,0
"RealThing:flexclust_no_s4","array",53,7,7,3,4,1,0,3,0,3,4,0,5,3,2,0,3,0
"RealThing:flexclust_no_s4","FUN",6,4,3,0,4,2,0,0,0,2,4,0,0,0,0,0,0,0
"RealThing:flexclust_no_s4","matrix",13,9,7,1,8,4,0,1,0,4,7,1,5,1,4,0,1,0
"RealThing:flexclust_no_s4","vector",2,2,2,0,2,2,0,0,0,0,0,2,1,0,1,0,0,0
"RealThing:flexclust_no_s4","is.factor",5,5,4,1,4,1,1,0,0,3,0,1,2,0,2,0,0,0
"RealThing:flexclust_no_s4","FUN",14,9,8,4,5,3,3,1,0,2,4,1,1,1,0,0,1,0
"RealThing:flexclust_no_s4","as.list",1,0,0,0,0,0,0,0,0,0,0,0,0,0,0,0,0,0
"RealThing:flexclust_no_s4","match",4,4,4,1,3,1,0,0,1,2,0,1,2,1,1,0,0,1
"RealThing:flexclust_no_s4",".row_names_info",2,2,2,0,2,1,0,0,0,1,0,1,1,0,1,0,0,0
"RealThing:flexclust_no_s4","force",1,1,1,1,0,0,0,1,0,0,0,0,1,1,0,0,1,0
"RealThing:flexclust_no_s4",".set_row_names",6,4,4,0,4,3,0,0,0,1,2,2,0,0,0,0,0,0
"RealThing:flexclust_no_s4","unknown--fromConstant",4,3,3,2,1,1,2,0,0,0,0,1,0,0,0,0,0,0
"RealThing:flexclust_no_s4","array",55,16,15,7,9,4,1,6,0,5,7,1,6,4,2,0,4,0
"RealThing:flexclust_no_s4","distEuclidean",91,49,28,11,38,11,11,0,0,27,35,2,5,0,5,0,0,0
"RealThing:flexclust_no_s4","unknown--fromConstant",4,3,3,2,1,1,2,0,0,0,0,1,0,0,0,0,0,0
"RealThing:flexclust_no_s4","unknown--fromConstant",4,3,3,2,1,1,2,0,0,0,0,1,0,0,0,0,0,0
"RealThing:flexclust_no_s4","unknown--fromConstant",4,3,3,1,2,2,1,0,0,0,0,2,0,0,0,0,0,0
"RealThing:flexclust_no_s4","mostattributes<-",110,42,41,12,30,20,11,1,0,10,23,4,2,1,1,1,0,0
"RealThing:flexclust_no_s4","isTRUE",11,8,7,1,7,1,1,0,0,6,6,0,0,0,0,0,0,0
"RealThing:flexclust_no_s4","aperm",1,0,0,0,0,0,0,0,0,0,0,0,0,0,0,0,0,0
"RealThing:flexclust_no_s4","unlist",27,5,5,0,5,5,0,0,0,0,5,0,2,0,2,0,0,0
"RealThing:flexclust_no_s4","as.vector",2,2,2,0,2,2,0,0,0,0,0,2,1,0,1,0,0,0
"RealThing:flexclust_no_s4","integer",1,1,1,0,1,0,0,0,0,1,0,0,0,0,0,0,0,0
"RealThing:flexclust_no_s4","is.factor",5,5,4,1,4,1,1,0,0,3,0,1,2,0,2,0,0,0
"RealThing:flexclust_no_s4","typeof",1,1,1,0,1,1,0,0,0,0,0,1,1,0,1,0,0,0
"RealThing:flexclust_no_s4","deparse",11,11,6,2,9,4,1,1,0,5,8,0,2,1,1,0,1,0
"RealThing:flexclust_no_s4","lapply",17,13,8,0,13,7,0,0,0,6,10,0,4,0,4,0,0,0
"RealThing:flexclust_no_s4","unique",1,0,0,0,0,0,0,0,0,0,0,0,0,0,0,0,0,0
"RealThing:flexclust_no_s4","vapply",17,11,9,0,11,8,0,0,0,3,7,2,4,0,4,0,0,0
"RealThing:flexclust_no_s4","as.list",1,0,0,0,0,0,0,0,0,0,0,0,0,0,0,0,0,0
"RealThing:flexclust_no_s4","tapply",241,112,71,33,79,28,24,9,0,51,70,3,10,3,7,0,3,0
"RealThing:flexclust_no_s4","split",1,0,0,0,0,0,0,0,0,0,0,0,0,0,0,0,0,0
"RealThing:flexclust_no_s4","FUN",1,0,0,0,0,0,0,0,0,0,0,0,0,0,0,0,0,0
"RealThing:flexclust_no_s4","vector",2,2,2,1,1,0,0,1,0,1,0,0,1,0,1,0,0,0
"RealThing:flexclust_no_s4","sort.int",239,37,27,11,26,12,7,4,0,14,26,0,0,0,0,0,0,0
"RealThing:flexclust_no_s4",".doSortWrap",53,19,18,9,10,8,7,2,0,2,10,0,0,0,0,0,0,0
"RealThing:flexclust_no_s4","matrix",13,9,9,2,7,5,1,1,0,2,6,1,5,2,3,1,1,0
"RealThing:flexclust_no_s4","unique.default",52,6,6,0,6,1,0,0,0,5,6,0,2,0,2,0,0,0
"RealThing:flexclust_no_s4","Sys.time",8,5,4,0,5,4,0,0,0,1,2,2,0,0,0,0,0,0
"RealThing:flexclust_no_s4","stdout",0,0,0,0,0,0,0,0,0,0,0,0,0,0,0,0,0,0
"RealThing:flexclust_no_s4","integer",1,1,1,0,1,1,0,0,0,0,0,1,0,0,0,0,0,0
"RealThing:flexclust_no_s4","unlist",27,5,5,1,4,4,0,1,0,0,4,0,2,1,1,0,1,0
"RealThing:flexclust_no_s4","FUN",33,22,19,6,16,11,4,2,0,5,11,3,2,2,0,1,1,0
"RealThing:flexclust_no_s4","aperm",1,0,0,0,0,0,0,0,0,0,0,0,0,0,0,0,0,0
"RealThing:flexclust_no_s4","apply",377,165,136,57,108,40,40,17,0,68,101,2,14,3,11,0,3,0
"RealThing:flexclust_no_s4","array",55,16,10,6,10,2,1,5,0,8,8,1,6,3,3,0,3,0
"RealThing:flexclust_no_s4","isFALSE",11,8,7,1,7,1,1,0,0,6,6,0,0,0,0,0,0,0
"RealThing:flexclust_no_s4","unique",1,0,0,0,0,0,0,0,0,0,0,0,0,0,0,0,0,0
"RealThing:flexclust_no_s4","is.vector",2,2,1,1,1,0,0,1,0,1,0,0,0,0,0,0,0,0
"RealThing:flexclust_no_s4","sys.call",1,1,1,0,1,0,0,0,0,1,0,0,0,0,0,0,0,0
"RealThing:flexclust_no_s4","distEuclidean",91,49,18,11,38,11,11,0,0,27,35,2,5,0,5,0,0,0
"RealThing:flexclust_no_s4","distEuclidean",91,49,28,11,38,11,11,0,0,27,35,2,5,0,5,0,0,0
"RealThing:flexclust_no_s4","kmeanspp",86,41,22,11,30,7,11,0,0,23,29,0,5,0,5,0,0,0
"RealThing:flexclust_no_s4","kmeansCluster",37,25,13,8,17,7,6,2,0,10,15,1,0,0,0,0,0,0
"RealThing:flexclust_no_s4","kmeansCluster",37,25,13,8,17,7,6,2,0,10,15,1,0,0,0,0,0,0
"RealThing:flexclust_no_s4","t",1,0,0,0,0,0,0,0,0,0,0,0,0,0,0,0,0,0
"RealThing:flexclust_no_s4","kmeansAllcent",70,35,16,13,22,8,12,1,0,14,21,0,5,0,5,0,0,0
"RealThing:flexclust_no_s4","kcca",291,162,104,39,123,53,36,3,0,70,114,5,5,0,5,0,0,0
"RealThing:flexclust_no_s4","unknown--fromConstant",4,3,3,2,1,1,2,0,0,0,0,1,0,0,0,0,0,0
"RealThing:flexclust_no_s4","unknown--fromConstant",4,3,3,2,1,1,2,0,0,0,0,1,0,0,0,0,0,0
"RealThing:flexclust_no_s4","unknown--fromConstant",4,3,3,1,2,2,1,0,0,0,0,2,0,0,0,0,0,0
"RealThing:flexclust_no_s4","summarizeCenters",112,83,21,6,77,18,6,0,0,59,69,5,2,0,2,0,0,0
"RealThing:flexclust_no_s4","append",54,11,9,7,4,2,3,4,0,2,3,1,0,0,0,0,0,0
"RealThing:flexclust_no_s4","na.omit",1,0,0,0,0,0,0,0,0,0,0,0,0,0,0,0,0,0
"RealThing:flexclust_no_s4","computeClusterSim",369,118,96,41,77,34,37,4,0,43,75,1,6,0,6,0,0,0
"RealThing:flexclust_no_s4","is.ordered",5,5,4,1,4,1,1,0,0,3,0,1,1,0,1,0,0,0
"RealThing:flexclust_no_s4","FUN",11,6,6,2,4,4,1,1,0,0,2,2,0,0,0,0,0,0
"RealThing:flexclust_no_s4","tabulate",28,16,15,3,13,8,2,1,0,5,10,1,1,0,1,0,0,0
"RealThing:flexclust_no_s4","make.names",20,18,12,4,14,5,1,3,0,9,11,1,0,0,0,0,0,0
"RealThing:flexclust_no_s4","unknown--fromConstant",4,3,3,2,1,1,2,0,0,0,0,1,0,0,0,0,0,0
"RealThing:flexclust_no_s4","unknown--fromConstant",4,3,3,2,1,1,2,0,0,0,0,1,0,0,0,0,0,0
"RealThing:flexclust_no_s4","t",1,0,0,0,0,0,0,0,0,0,0,0,0,0,0,0,0,0
"RealThing:flexclust_no_s4","kcca",287,159,101,39,120,52,36,3,0,68,112,4,5,0,5,0,0,0
"RealThing:flexclust_no_s4","unknown--fromConstant",4,3,3,2,1,1,2,0,0,0,0,1,0,0,0,0,0,0
"RealThing:flexclust_no_s4","unknown--fromConstant",4,3,3,2,1,1,2,0,0,0,0,1,0,0,0,0,0,0
"RealThing:flexclust_no_s4","unknown--fromConstant",4,3,3,1,2,2,1,0,0,0,0,2,0,0,0,0,0,0
"RealThing:flexclust_no_s4","execute",36,20,6,0,20,4,0,0,0,16,14,2,2,0,2,0,0,0
"RealThing:flexclust_no_s4","set.seed",84,11,5,1,10,4,1,0,0,6,9,1,0,0,0,0,0,0
"RealThing:flexclust_no_s4","numeric",1,1,1,0,1,1,0,0,0,0,0,1,0,0,0,0,0,0
"RealThing:flexclust_no_s4","asplit",162,86,68,30,56,20,18,12,0,36,52,2,7,4,3,0,4,0
"RealThing:flexclust_no_s4","do.call",9,6,5,1,5,4,0,1,0,1,3,2,0,0,0,0,0,0
"RealThing:flexclust_no_s4",".row_names_info",2,2,2,0,2,2,0,0,0,0,0,2,1,0,1,0,0,0
"RealThing:flexclust_no_s4","array",55,16,15,6,10,3,1,5,0,7,8,1,6,3,3,0,3,0
"RealThing:flexclust_no_s4","apply",377,165,136,57,108,40,40,17,0,68,101,2,14,3,11,0,3,0
"RealThing:flexclust_no_s4","array",55,16,10,6,10,2,1,5,0,8,8,1,6,3,3,0,3,0
"RealThing:flexclust_no_s4","match",4,4,4,1,3,1,1,0,0,2,0,1,2,1,1,1,0,0
"RealThing:flexclust_no_s4","vector",2,2,2,1,1,1,0,1,0,0,0,1,1,1,0,0,1,0
"kaggle:titanic","match.fun",40,3,3,1,2,1,0,1,0,1,1,1,2,1,1,0,1,0
"kaggle:titanic","inherits",3,3,3,0,3,3,0,0,0,0,0,3,1,0,1,0,0,0
"kaggle:titanic","is.vector",2,2,1,0,2,1,0,0,0,1,0,1,1,0,1,0,0,0
"kaggle:titanic","lapply",17,13,8,0,13,7,0,0,0,6,10,0,9,0,9,0,0,0
"kaggle:titanic","is.numeric_version",5,5,4,1,4,1,1,0,0,3,0,1,2,0,2,0,0,0
"kaggle:titanic","nchar",4,4,4,0,4,1,0,0,0,3,2,1,0,0,0,0,0,0
"kaggle:titanic","match",4,4,4,1,3,2,0,1,0,1,1,1,1,0,1,0,0,0
"kaggle:titanic","unique",1,0,0,0,0,0,0,0,0,0,0,0,0,0,0,0,0,0
"kaggle:titanic","is.factor",5,5,4,1,4,1,1,0,0,3,0,1,2,0,2,0,0,0
"kaggle:titanic","unlist",27,5,5,0,5,4,0,0,0,1,5,0,2,0,2,0,0,0
"kaggle:titanic",".make_numeric_version",124,61,45,16,45,25,7,9,0,20,34,3,13,2,11,1,1,0
"kaggle:titanic","integer",1,1,1,0,1,0,0,0,0,1,0,0,0,0,0,0,0,0
"kaggle:titanic","FUN",48,19,11,4,15,5,4,0,0,10,7,2,3,0,3,0,0,0
"kaggle:titanic","strrep",10,5,5,1,4,3,1,0,0,1,3,1,0,0,0,0,0,0
"kaggle:titanic","%in%",8,8,8,3,5,3,1,2,0,2,0,3,5,2,3,1,1,0
"kaggle:titanic","unknown--fromConstant",5,4,4,0,4,3,0,0,0,1,2,2,0,0,0,0,0,0
"kaggle:titanic","identical",8,8,8,0,8,8,0,0,0,0,8,0,2,0,2,0,0,0
"kaggle:titanic","asNamespace",28,22,18,4,18,7,4,0,0,11,17,1,2,0,2,0,0,0
"kaggle:titanic","isNamespace",1,1,1,0,1,1,0,0,0,0,0,1,0,0,0,0,0,0
"kaggle:titanic","isBaseNamespace",11,11,9,1,10,2,1,0,0,8,10,0,2,0,2,0,0,0
"kaggle:titanic","sys.frame",1,1,1,0,1,1,0,0,0,0,0,1,0,0,0,0,0,0
"kaggle:titanic","match",4,4,4,1,3,1,0,1,0,2,0,1,1,0,1,0,0,0
"kaggle:titanic",".identC",7,4,4,1,3,3,1,0,0,0,0,3,1,0,1,0,0,0
"kaggle:titanic","getClassDef",49,10,9,0,10,6,0,0,0,4,4,4,0,0,0,0,0,0
"kaggle:titanic",".getClassesFromCache",7,4,4,0,4,4,0,0,0,0,0,4,0,0,0,0,0,0
"kaggle:titanic","getClassDef",49,10,9,0,10,6,0,0,0,4,4,4,0,0,0,0,0,0
"kaggle:titanic","getClassDef",49,10,9,0,10,6,0,0,0,4,4,4,0,0,0,0,0,0
"kaggle:titanic","is",124,39,32,12,27,15,6,6,0,12,23,3,1,0,1,0,0,0
"kaggle:titanic","parent.frame",1,1,1,0,1,1,0,0,0,0,0,1,0,0,0,0,0,0
"kaggle:titanic","get0",6,5,5,0,5,5,0,0,0,0,0,5,3,0,3,0,0,0
"kaggle:titanic","typeof",1,1,1,0,1,1,0,0,0,0,0,1,1,0,1,0,0,0
"kaggle:titanic","parent.env",1,1,1,0,1,1,0,0,0,0,0,1,0,0,0,0,0,0
"kaggle:titanic",".registerS3method",77,39,28,10,29,13,2,8,0,16,18,6,4,0,4,0,0,0
"kaggle:titanic","delayedAssign",7,5,4,1,4,3,0,1,0,1,3,1,0,0,0,0,0,0
"kaggle:titanic","asNamespace",28,24,20,5,19,9,4,1,0,10,17,2,2,0,2,0,0,0
"kaggle:titanic","asNamespace",33,27,21,4,23,10,4,0,0,13,19,3,3,0,3,0,0,0
"kaggle:titanic","environment",1,1,1,1,0,0,0,1,0,0,0,0,1,1,0,0,1,0
"kaggle:titanic",".registerS3method",77,41,29,10,31,14,2,8,0,17,21,5,7,1,6,0,1,0
"kaggle:titanic","asNamespace",33,27,21,5,22,10,4,1,0,12,19,2,3,1,2,0,1,0
"kaggle:titanic","setNamespaceInfo",7,7,7,4,3,2,1,3,0,1,3,0,1,1,0,1,0,0
"kaggle:titanic","asNamespace",33,27,15,4,23,10,4,0,0,13,19,3,3,0,3,0,0,0
"kaggle:titanic",".getNamespaceInfo",5,4,4,2,2,2,0,2,0,0,1,1,1,0,1,0,0,0
"kaggle:titanic","%in%",8,8,8,2,6,3,1,1,0,3,0,3,5,1,4,1,0,0
"kaggle:titanic","character",1,1,1,0,1,0,0,0,0,1,0,0,0,0,0,0,0,0
"kaggle:titanic","readRDS",21,11,9,0,11,8,0,0,0,3,8,3,0,0,0,0,0,0
"kaggle:titanic","isTRUE",11,8,7,4,4,1,3,1,0,3,3,0,1,1,0,0,1,0
"kaggle:titanic","FUN",3,3,1,0,3,1,0,0,0,2,0,1,0,0,0,0,0,0
"kaggle:titanic","FUN",8,8,3,0,8,3,0,0,0,5,2,2,2,0,2,0,0,0
"kaggle:titanic","strlpad",11,11,2,0,11,2,0,0,0,9,6,1,0,0,0,0,0,0
"kaggle:titanic","which",12,3,2,1,2,1,1,0,0,1,0,1,0,0,0,0,0,0
"kaggle:titanic","rep.int",2,2,2,2,0,0,1,1,0,0,0,0,2,2,0,1,1,0
"kaggle:titanic","new.env",4,4,3,2,2,0,1,1,0,2,0,0,1,1,0,0,1,0
"kaggle:titanic","asNamespace",33,27,21,4,23,10,4,0,0,13,19,3,3,0,3,0,0,0
"kaggle:titanic","is.vector",2,2,1,0,2,1,0,0,0,1,0,1,1,0,1,0,0,0
"kaggle:titanic",".standard_regexps",1,1,1,0,1,1,0,0,0,0,0,1,0,0,0,0,0,0
"kaggle:titanic","unknown--fromConstant",5,4,4,0,4,3,0,0,0,1,2,2,0,0,0,0,0,0
"kaggle:titanic","grepl",56,16,14,3,13,9,2,1,0,4,9,1,2,0,2,0,0,0
"kaggle:titanic","unique",1,0,0,0,0,0,0,0,0,0,0,0,0,0,0,0,0,0
"kaggle:titanic","unlist",27,5,5,0,5,5,0,0,0,0,5,0,2,0,2,0,0,0
"kaggle:titanic","lapply",17,16,10,0,16,9,0,0,0,7,13,1,9,0,9,0,0,0
"kaggle:titanic","as.list",1,0,0,0,0,0,0,0,0,0,0,0,0,0,0,0,0,0
"kaggle:titanic","setNamespaceInfo",7,7,7,4,3,2,1,3,0,1,3,0,1,1,0,1,0,0
"kaggle:titanic","getNamespaceName",23,22,18,5,17,6,2,3,0,11,14,2,3,0,3,0,0,0
"kaggle:titanic","%in%",8,8,8,2,6,3,1,1,0,3,0,3,5,1,4,1,0,0
"kaggle:titanic","startsWith",2,2,2,0,2,2,0,0,0,0,0,2,0,0,0,0,0,0
"kaggle:titanic","sys.frame",1,1,1,0,1,1,0,0,0,0,0,1,0,0,0,0,0,0
"kaggle:titanic","dynGet",108,70,52,17,53,27,11,6,0,26,47,1,12,3,9,0,3,0
"kaggle:titanic","get0",6,5,5,1,4,4,0,1,0,0,0,4,3,1,2,0,1,0
"kaggle:titanic","sys.nframe",0,0,0,0,0,0,0,0,0,0,0,0,0,0,0,0,0,0
"kaggle:titanic","environmentIsLocked",1,1,1,0,1,1,0,0,0,0,0,1,0,0,0,0,0,0
"kaggle:titanic","strsplit",7,6,4,2,4,2,1,1,0,2,4,0,0,0,0,0,0,0
"kaggle:titanic","parent.frame",1,1,1,0,1,0,0,0,0,1,0,0,0,0,0,0,0,0
"kaggle:titanic","getNamespaceInfo",6,6,3,0,6,3,0,0,0,3,4,1,1,0,1,0,0,0
"kaggle:titanic","get",6,4,4,1,3,3,0,1,0,0,0,3,1,1,0,0,1,0
"kaggle:titanic","environment",1,1,1,0,1,0,0,0,0,1,0,0,1,0,1,0,0,0
"kaggle:titanic","FUN",4,4,4,3,1,1,1,2,0,0,0,1,0,0,0,0,0,0
"kaggle:titanic","FUN",40,23,12,6,17,6,1,5,0,11,14,1,2,0,2,0,0,0
"kaggle:titanic","exists",8,4,4,1,3,3,0,1,0,0,1,2,0,0,0,0,0,0
"kaggle:titanic","tryCatchList",35,12,7,1,11,4,1,0,0,7,8,0,2,0,2,0,0,0
"kaggle:titanic","tryCatchOne",30,4,0,0,4,0,0,0,0,4,0,0,1,0,1,0,0,0
"kaggle:titanic","doTryCatch",7,6,6,0,6,5,0,0,0,1,3,3,0,0,0,0,0,0
"kaggle:titanic","vapply",17,11,9,0,11,8,0,0,0,3,6,3,6,0,6,0,0,0
"kaggle:titanic","",81,43,32,19,24,9,7,12,0,15,21,3,0,0,0,0,0,0
"kaggle:titanic","existsInFrame",2,2,2,1,1,1,0,1,0,0,0,1,0,0,0,0,0,0
"kaggle:titanic","parent.env<-",2,2,2,0,2,2,0,0,0,0,2,0,0,0,0,0,0,0
"kaggle:titanic","as.list",1,0,0,0,0,0,0,0,0,0,0,0,0,0,0,0,0,0
"kaggle:titanic","do.call",9,6,5,1,5,4,0,1,0,1,3,2,2,1,1,0,1,0
"kaggle:titanic","eval",8,6,3,1,5,2,0,1,0,3,5,0,1,1,0,0,1,0
"kaggle:titanic","delayedAssign",7,5,4,0,5,4,0,0,0,1,3,2,0,0,0,0,0,0
"kaggle:titanic","sys.parent",1,1,1,0,1,0,0,0,0,1,0,0,0,0,0,0,0,0
"kaggle:titanic","formals",10,3,3,1,2,2,0,1,0,0,1,1,0,0,0,0,0,0
"kaggle:titanic","sys.function",1,1,1,1,0,0,1,0,0,0,0,0,0,0,0,0,0,0
"kaggle:titanic","match.arg",77,53,42,15,38,16,10,5,0,22,32,0,5,0,5,0,0,0
"kaggle:titanic","strsplit",7,6,3,1,5,2,0,1,0,3,5,0,0,0,0,0,0,0
"kaggle:titanic","get0",6,5,5,1,4,4,0,1,0,0,0,4,3,1,2,0,1,0
"kaggle:titanic","getHook",4,4,1,0,4,1,0,0,0,3,2,0,0,0,0,0,0,0
"kaggle:titanic","match.arg",77,53,42,15,38,16,10,5,0,22,32,0,5,0,5,0,0,0
"kaggle:titanic","packageEvent",21,19,10,2,17,5,0,2,0,12,13,1,2,0,2,0,0,0
"kaggle:titanic","isNamespaceLoaded",1,1,1,0,1,1,0,0,0,0,0,1,0,0,0,0,0,0
"kaggle:titanic","assign",6,4,4,1,3,3,0,1,0,0,0,3,0,0,0,0,0,0
"kaggle:titanic","setHook",38,19,10,4,15,4,1,3,0,11,11,0,2,1,1,0,1,0
"kaggle:titanic","which",12,3,2,1,2,1,1,0,0,1,0,1,2,1,1,1,0,0
"kaggle:titanic","NextMethod",4,1,1,0,1,1,0,0,0,0,0,1,1,0,1,0,0,0
"kaggle:titanic","match",4,4,4,2,2,1,0,2,0,1,0,1,1,1,0,0,1,0
"kaggle:titanic","anyDuplicated",1,0,0,0,0,0,0,0,0,0,0,0,0,0,0,0,0,0
"kaggle:titanic","%in%",8,8,8,3,5,2,1,2,0,3,0,2,5,2,3,1,1,0
"kaggle:titanic","vapply",17,11,9,0,11,8,0,0,0,3,4,5,7,0,7,0,0,0
"kaggle:titanic","unique",1,0,0,0,0,0,0,0,0,0,0,0,0,0,0,0,0,0
"kaggle:titanic","setdiff",22,18,15,2,16,12,0,2,0,4,13,2,11,2,9,0,2,0
"kaggle:titanic","as.vector",2,2,2,1,1,0,0,1,0,1,0,0,1,1,0,0,1,0
"kaggle:titanic",".rlang_vctrs_typeof",33,16,11,0,16,2,0,0,0,14,13,1,3,0,3,0,0,0
"kaggle:titanic","accessor",1,1,1,0,1,0,0,0,0,1,0,0,0,0,0,0,0,0
"kaggle:titanic",".row_names_info",2,2,2,0,2,2,0,0,0,0,0,2,0,0,0,0,0,0
"kaggle:titanic","isFALSE",11,8,7,1,7,1,1,0,0,6,6,0,0,0,0,0,0,0
"kaggle:titanic","identical",8,8,8,0,8,2,0,0,0,6,8,0,2,0,2,0,0,0
"kaggle:titanic","integer",1,1,1,0,1,1,0,0,0,0,0,1,1,0,1,0,0,0
"kaggle:titanic","vec_size",16,14,11,6,8,3,5,1,0,5,0,3,5,1,4,0,1,0
"kaggle:titanic","is.data.frame",5,5,4,1,4,1,1,0,0,3,0,1,2,0,2,0,0,0
"kaggle:titanic","new_data_frame",37,32,22,9,23,10,8,1,0,13,12,4,10,1,9,0,1,0
"kaggle:titanic","",144,79,52,15,64,26,12,3,0,38,47,7,20,1,19,0,1,0
"kaggle:titanic",".rlang_vctrs_typeof",41,24,20,3,21,8,3,0,0,13,18,2,5,0,5,0,0,0
"kaggle:titanic","FUN",11,7,7,4,3,2,3,1,0,1,0,2,1,0,1,0,0,0
"kaggle:titanic","unknown--fromConstant",4,1,1,1,0,0,1,0,0,0,0,0,0,0,0,0,0,0
"kaggle:titanic","",10,10,9,1,9,1,1,0,0,8,9,0,2,0,2,0,0,0
"kaggle:titanic",".set_row_names",6,5,5,0,5,4,0,0,0,1,4,1,0,0,0,0,0,0
"kaggle:titanic","vec_is_unspecified",19,6,6,0,6,4,0,0,0,2,2,2,2,0,2,0,0,0
"kaggle:titanic","as.list",1,0,0,0,0,0,0,0,0,0,0,0,0,0,0,0,0,0
"kaggle:titanic","vec_size",16,14,11,6,8,3,5,1,0,5,0,3,5,1,4,0,1,0
"kaggle:titanic","is_function",5,3,3,1,2,2,1,0,0,0,0,2,1,0,1,0,0,0
"kaggle:titanic",".row_names_info",2,2,2,0,2,2,0,0,0,0,0,2,0,0,0,0,0,0
"kaggle:titanic","strrep",10,5,5,1,4,4,1,0,0,0,2,2,1,1,0,1,0,0
"kaggle:titanic","is",124,42,35,13,29,17,7,6,0,12,24,5,10,2,8,0,2,0
"kaggle:titanic","identical",8,8,8,0,8,2,0,0,0,6,8,0,2,0,2,0,0,0
"kaggle:titanic",".getGeneric",50,31,23,5,26,17,3,2,0,9,15,5,8,1,7,1,0,0
"kaggle:titanic",".getGeneric",50,31,23,5,26,17,3,2,0,9,15,5,8,1,7,1,0,0
"kaggle:titanic",".updateMethodsInTable",106,70,41,13,57,19,7,6,0,38,51,3,3,0,3,0,0,0
"kaggle:titanic",".updateMethodsInTable",106,70,41,13,57,19,7,6,0,38,51,3,3,0,3,0,0,0
"kaggle:titanic","match",4,4,4,2,2,0,0,2,0,2,0,0,1,1,0,0,1,0
"kaggle:titanic","environment",1,1,1,0,1,1,0,0,0,0,0,1,1,0,1,0,0,0
"kaggle:titanic","genericForBasic",13,5,5,2,3,3,0,2,0,0,2,1,0,0,0,0,0,0
"kaggle:titanic","exists",8,6,4,1,5,3,0,1,0,2,3,2,1,1,0,0,1,0
"kaggle:titanic","remove",46,29,25,6,23,14,2,4,0,9,14,6,7,0,7,0,0,0
"kaggle:titanic","sapply",32,20,15,4,16,8,4,0,0,8,14,1,0,0,0,0,0,0
"kaggle:titanic","getGroupMembers",38,25,12,3,22,7,2,1,0,15,20,1,2,0,2,0,0,0
"kaggle:titanic",".getGenericFromCacheTable",59,10,6,2,8,3,2,0,0,5,7,1,0,0,0,0,0,0
"kaggle:titanic",".resetInheritedMethods",50,27,18,11,16,5,4,7,0,11,15,0,10,2,8,1,1,0
"kaggle:titanic","getGeneric",132,51,30,11,40,19,6,5,0,21,36,1,5,0,5,0,0,0
"kaggle:titanic","getGeneric",132,51,30,11,40,19,6,5,0,21,36,1,5,0,5,0,0,0
"kaggle:titanic",".recMembers",61,45,34,18,27,12,7,11,0,15,23,2,2,0,2,0,0,0
"kaggle:titanic",".getGeneric",50,31,23,5,26,17,3,2,0,9,15,5,8,1,7,1,0,0
"kaggle:titanic","genericForBasic",13,5,5,2,3,3,0,2,0,0,2,1,0,0,0,0,0,0
"kaggle:titanic","exists",8,6,4,1,5,3,0,1,0,2,3,2,1,1,0,0,1,0
"kaggle:titanic",".getGenericFromCacheTable",59,10,6,2,8,3,2,0,0,5,7,1,0,0,0,0,0,0
"kaggle:titanic",".getGeneric",50,31,23,5,26,17,3,2,0,9,15,5,8,1,7,1,0,0
"kaggle:titanic","genericForBasic",13,5,5,2,3,3,0,2,0,0,2,1,0,0,0,0,0,0
"kaggle:titanic","FUN",10,7,6,3,4,3,1,2,0,1,3,1,0,0,0,0,0,0
"kaggle:titanic","environment",1,1,1,0,1,1,0,0,0,0,0,1,1,0,1,0,0,0
"kaggle:titanic","FUN",13,3,2,1,2,1,1,0,0,1,2,0,0,0,0,0,0,0
"kaggle:titanic","lapply",17,16,10,0,16,9,0,0,0,7,13,1,9,0,9,0,0,0
"kaggle:titanic","is",124,42,35,13,29,17,7,6,0,12,24,5,10,2,8,0,2,0
"kaggle:titanic",".getGeneric",50,31,23,5,26,17,3,2,0,9,15,5,8,1,7,1,0,0
"kaggle:titanic","genericForBasic",13,5,5,2,3,3,0,2,0,0,2,1,0,0,0,0,0,0
"kaggle:titanic","getGroupMembers",38,25,12,3,22,7,2,1,0,15,20,1,2,0,2,0,0,0
"kaggle:titanic",".getGeneric",50,31,22,5,26,17,3,2,0,9,15,5,8,1,7,1,0,0
"kaggle:titanic",".getGeneric",50,31,22,5,26,17,3,2,0,9,15,5,8,1,7,1,0,0
"kaggle:titanic","genericForBasic",13,5,5,2,3,3,0,2,0,0,2,1,0,0,0,0,0,0
"kaggle:titanic","getGeneric",132,51,30,10,41,20,5,5,0,21,37,1,5,0,5,0,0,0
"kaggle:titanic","parent.frame",1,1,1,0,1,1,0,0,0,0,0,1,1,0,1,0,0,0
"kaggle:titanic",".getGeneric",50,31,23,5,26,17,3,2,0,9,15,5,8,1,7,1,0,0
"kaggle:titanic","lapply",17,16,10,0,16,9,0,0,0,7,13,1,9,0,9,0,0,0
"kaggle:titanic","environment",1,1,1,0,1,1,0,0,0,0,0,1,1,0,1,0,0,0
"kaggle:titanic","environment",1,1,1,0,1,1,0,0,0,0,0,1,1,0,1,0,0,0
"kaggle:titanic","genericForBasic",13,5,5,2,3,3,0,2,0,0,2,1,0,0,0,0,0,0
"kaggle:titanic",".checkGroupSigLength",194,82,69,37,45,22,21,16,0,23,41,3,1,0,1,0,0,0
"kaggle:titanic","getGroupMembers",38,25,12,3,22,7,2,1,0,15,20,1,2,0,2,0,0,0
"kaggle:titanic","vector",2,2,2,1,1,1,0,1,0,0,0,1,1,1,0,0,1,0
"kaggle:titanic","setdiff",22,18,15,2,16,11,0,2,0,5,13,2,11,2,9,0,2,0
"kaggle:titanic",".recMembers",61,45,34,18,27,12,7,11,0,15,23,2,2,0,2,0,0,0
"kaggle:titanic",".getGeneric",50,31,23,5,26,17,3,2,0,9,15,5,8,1,7,1,0,0
"kaggle:titanic","genericForBasic",13,5,5,2,3,3,0,2,0,0,2,1,0,0,0,0,0,0
"kaggle:titanic","accessor",1,1,1,1,0,0,1,0,0,0,0,0,0,0,0,0,0,0
"kaggle:titanic",".getGeneric",50,31,23,5,26,17,3,2,0,9,15,5,8,1,7,1,0,0
"kaggle:titanic","environment",1,1,1,0,1,1,0,0,0,0,0,1,1,0,1,0,0,0
"kaggle:titanic","genericForBasic",13,5,5,2,3,3,0,2,0,0,2,1,0,0,0,0,0,0
"kaggle:titanic",".checkGroupSigLength",194,82,69,36,46,22,21,15,0,24,42,3,1,0,1,0,0,0
"kaggle:titanic","getGroupMembers",38,25,12,3,22,7,2,1,0,15,20,1,2,0,2,0,0,0
"kaggle:titanic",".getGeneric",50,31,23,5,26,17,3,2,0,9,15,5,8,1,7,1,0,0
"kaggle:titanic","genericForBasic",13,5,5,2,3,3,0,2,0,0,2,1,0,0,0,0,0,0
"kaggle:titanic","isGroup",7,2,1,1,1,0,1,0,0,1,0,0,0,0,0,0,0,0
"kaggle:titanic","cacheGenericsMetaData",108,54,30,7,47,16,6,1,0,31,34,8,8,1,7,0,1,0
"kaggle:titanic","getGeneric",132,51,30,11,40,19,6,5,0,21,36,1,5,0,5,0,0,0
"kaggle:titanic","",27,4,4,1,3,1,0,1,0,2,1,1,2,1,1,0,1,0
"kaggle:titanic","dispatchIsInternal",11,7,6,1,6,2,1,0,0,4,1,2,3,0,3,0,0,0
"kaggle:titanic",".cacheGeneric",68,23,12,4,19,8,2,2,0,11,17,0,2,0,2,0,0,0
"kaggle:titanic","setPrimitiveMethods",16,7,7,0,7,7,0,0,0,0,3,4,0,0,0,0,0,0
"kaggle:titanic",".getMethodsTable",14,10,3,1,9,1,1,0,0,8,8,0,0,0,0,0,0,0
"kaggle:titanic","find.package",310,87,62,32,55,24,17,15,0,31,43,5,17,5,12,2,3,0
"kaggle:titanic","tryCatch",53,26,17,7,19,7,3,4,0,12,15,1,4,0,4,0,0,0
"kaggle:titanic","do.call",9,6,5,1,5,4,0,1,0,1,3,2,3,1,2,0,1,0
"kaggle:titanic","grepl",56,16,14,3,13,9,2,1,0,4,9,1,2,0,2,0,0,0
"kaggle:titanic","ncol",4,3,3,1,2,2,1,0,0,0,0,2,0,0,0,0,0,0
"kaggle:titanic","methodsPackageMetaName",9,5,5,0,5,5,0,0,0,0,4,1,0,0,0,0,0,0
"kaggle:titanic","Sys.getenv",59,19,18,6,13,7,4,2,0,6,11,0,1,0,1,0,0,0
"kaggle:titanic","classMetaName",11,7,6,0,7,6,0,0,0,1,6,1,0,0,0,0,0,0
"kaggle:titanic",".getGeneric",50,31,22,5,26,17,3,2,0,9,15,5,8,1,7,1,0,0
"kaggle:titanic","genericForBasic",13,5,5,2,3,3,0,2,0,0,2,1,0,0,0,0,0,0
"kaggle:titanic","getGeneric",132,51,30,10,41,20,5,5,0,21,37,1,5,0,5,0,0,0
"kaggle:titanic","lengths",2,2,2,1,1,1,0,1,0,0,0,1,1,1,0,0,1,0
"kaggle:titanic","simplify2array",151,23,20,8,15,8,5,3,0,7,14,1,2,0,2,0,0,0
"kaggle:titanic","character",1,1,1,0,1,1,0,0,0,0,0,1,0,0,0,0,0,0
"kaggle:titanic","FUN",36,15,6,2,13,4,1,1,0,9,8,2,1,0,1,0,0,0
"kaggle:titanic","tryCatch",53,26,17,7,19,7,3,4,0,12,15,1,4,0,4,0,0,0
"kaggle:titanic","aperm",1,0,0,0,0,0,0,0,0,0,0,0,0,0,0,0,0,0
"kaggle:titanic","apply",375,126,112,48,78,32,39,9,0,46,73,1,4,0,4,0,0,0
"kaggle:titanic","normalizePath",5,5,4,0,5,4,0,0,0,1,3,2,0,0,0,0,0,0
"kaggle:titanic","matrix",13,9,6,0,9,4,0,0,0,5,8,0,2,0,2,0,0,0
"kaggle:titanic","strsplit",7,6,3,2,4,1,0,2,0,3,4,0,0,0,0,0,0,0
"kaggle:titanic","nchar",4,4,4,1,3,0,0,1,0,3,2,0,1,1,0,0,1,0
"kaggle:titanic","vapply",17,11,9,0,11,8,0,0,0,3,4,5,7,0,7,0,0,0
"kaggle:titanic","list2env",2,2,2,1,1,1,0,1,0,0,0,1,0,0,0,0,0,0
"kaggle:titanic","nrow",4,3,3,1,2,2,1,0,0,0,0,2,1,0,1,0,0,0
"kaggle:titanic","lockEnvironment",2,2,2,1,1,1,0,1,0,0,0,1,1,1,0,0,1,0
"kaggle:titanic","packageEvent",21,19,10,1,18,6,0,1,0,12,12,3,4,0,4,0,0,0
"kaggle:titanic","tryCatch",53,26,17,7,19,7,3,4,0,12,15,1,4,0,4,0,0,0
"kaggle:titanic","try",4,2,1,0,2,1,0,0,0,1,2,0,2,0,2,0,0,0
"kaggle:titanic","do.call",9,6,5,1,5,4,0,1,0,1,3,2,3,1,2,0,1,0
"kaggle:titanic",".make_numeric_version",51,32,23,11,21,9,4,6,1,12,17,2,6,3,3,0,2,1
"kaggle:titanic","which",12,3,2,1,2,1,1,0,0,1,0,1,2,1,1,1,0,0
"kaggle:titanic","NextMethod",4,1,1,0,1,1,0,0,0,0,0,1,1,0,1,0,0,0
"kaggle:titanic","split",1,0,0,0,0,0,0,0,0,0,0,0,0,0,0,0,0,0
"kaggle:titanic",".encode_numeric_version",158,92,58,12,80,38,7,5,0,42,61,7,43,4,39,1,3,0
"kaggle:titanic","ifelse",105,31,31,15,16,10,11,4,0,6,12,2,18,9,9,7,2,0
"kaggle:titanic","sort.int",239,13,11,1,12,7,1,0,0,5,12,0,0,0,0,0,0,0
"kaggle:titanic","makeImportExportNames",20,9,9,3,6,5,0,3,0,1,5,1,0,0,0,0,0,0
"kaggle:titanic","namespaceIsSealed",3,3,2,1,2,1,1,0,0,1,0,1,0,0,0,0,0,0
"kaggle:titanic","whichMethodMetaNames",12,8,7,3,5,3,3,0,0,2,3,1,0,0,0,0,0,0
"kaggle:titanic","importIntoEnv",90,33,22,3,30,17,2,1,0,13,22,4,7,1,6,1,0,0
"kaggle:titanic","asNamespace",33,27,15,5,22,9,4,1,0,13,19,2,3,1,2,0,1,0
"kaggle:titanic","asNamespace",33,27,15,5,22,9,4,1,0,13,19,2,3,1,2,0,1,0
"kaggle:titanic","addImports",96,63,37,16,47,20,7,9,0,27,41,1,13,3,10,1,2,0
"kaggle:titanic","new.env",4,4,3,2,2,0,1,1,0,2,0,0,1,1,0,0,1,0
"kaggle:titanic","mkenv",1,1,1,1,0,0,0,1,0,0,0,0,0,0,0,0,0,0
"kaggle:titanic","as.name",1,1,1,0,1,1,0,0,0,0,0,1,0,0,0,0,0,0
"kaggle:titanic","lazyLoadDBexec",46,36,24,7,29,15,3,4,0,14,24,3,0,0,0,0,0,0
"kaggle:titanic","readRDS",11,8,7,0,8,6,0,0,0,2,6,2,0,0,0,0,0,0
"kaggle:titanic","close",1,1,1,0,1,1,0,0,0,0,0,1,0,0,0,0,0,0
"kaggle:titanic","environment",0,0,0,0,0,0,0,0,0,0,0,0,0,0,0,0,0,0
"kaggle:titanic",".dynLibs",4,2,2,0,2,2,0,0,0,0,2,0,0,0,0,0,0,0
"kaggle:titanic","FUN",6,2,2,0,2,2,0,0,0,0,0,2,0,0,0,0,0,0
"kaggle:titanic","tolower",7,3,3,1,2,2,0,1,0,0,1,1,2,1,1,0,1,0
"kaggle:titanic","pmatch",8,6,6,2,4,2,0,2,0,2,2,0,0,0,0,0,0,0
"kaggle:titanic","vector",2,2,2,0,2,2,0,0,0,0,0,2,1,0,1,0,0,0
"kaggle:titanic","unlist",27,5,5,1,4,4,0,1,0,0,4,0,2,1,1,0,1,0
"kaggle:titanic","rm",46,35,27,7,28,15,3,4,0,13,19,4,13,2,11,0,2,0
"kaggle:titanic","",113,64,38,9,55,22,9,0,0,33,50,2,0,0,0,0,0,0
"kaggle:titanic","regularize.values",152,50,41,16,34,13,14,2,0,21,34,0,2,0,2,0,0,0
"kaggle:titanic","fx",10,6,4,0,6,4,0,0,0,2,5,1,5,0,5,0,0,0
"kaggle:titanic","unknown--fromConstant",45,18,16,4,14,10,2,2,0,4,10,1,5,0,5,0,0,0
"kaggle:titanic","is.logint",9,6,5,0,6,1,0,0,0,5,3,1,1,0,1,0,0,0
"kaggle:titanic","lintrj",7,7,7,1,6,5,1,0,0,1,6,0,0,0,0,0,0,0
"kaggle:titanic","",107,45,36,10,35,18,6,4,0,17,26,6,3,0,3,0,0,0
"kaggle:titanic","colour_ramp",101,53,34,9,44,25,7,2,0,19,34,7,3,0,3,0,0,0
"kaggle:titanic","as_white_ref",129,59,52,15,44,29,7,8,0,15,41,2,6,2,4,0,2,0
"kaggle:titanic","colnames<-",38,28,25,8,20,12,5,3,0,8,12,3,3,0,3,0,0,0
"kaggle:titanic","unknown--fromOverride",489,69,64,18,51,31,15,3,0,20,46,1,2,1,1,0,1,0
"kaggle:titanic","",409,109,70,12,97,47,8,4,0,50,90,4,4,0,4,0,0,0
"kaggle:titanic","rownames",17,6,6,1,5,2,0,1,0,3,4,1,0,0,0,0,0,0
"kaggle:titanic","hcl",13,7,7,0,7,7,0,0,0,0,3,4,2,0,2,0,0,0
"kaggle:titanic","colourspace_match",23,16,14,3,13,7,1,2,0,6,8,2,2,0,2,0,0,0
"kaggle:titanic","chkDots",15,1,1,1,0,0,1,0,0,0,0,0,0,0,0,0,0,0
"kaggle:titanic","lintrj",7,7,7,3,4,3,3,0,0,1,4,0,0,0,0,0,0,0
"kaggle:titanic","seqhcl",66,53,25,4,49,18,3,1,0,31,43,5,2,0,2,0,0,0
"kaggle:titanic","lintrj",7,7,7,3,4,3,3,0,0,1,4,0,0,0,0,0,0,0
"kaggle:titanic","tritrj",26,26,1,0,26,1,0,0,0,25,25,0,0,0,0,0,0,0
"kaggle:titanic","ifelse",105,36,35,18,18,11,13,5,0,7,13,3,20,11,9,6,5,0
"kaggle:titanic","charmatch",7,5,5,2,3,3,0,2,0,0,2,1,0,0,0,0,0,0
"kaggle:titanic","seqhcl",66,53,25,4,49,18,3,1,0,31,43,5,2,0,2,0,0,0
"kaggle:titanic","rev",1,0,0,0,0,0,0,0,0,0,0,0,0,0,0,0,0,0
"kaggle:titanic","",409,168,95,20,148,59,13,7,0,89,141,4,4,0,4,0,0,0
"kaggle:titanic","rev",1,0,0,0,0,0,0,0,0,0,0,0,0,0,0,0,0,0
"kaggle:titanic","",396,234,112,29,205,64,19,10,0,141,202,0,2,0,2,0,0,0
"kaggle:titanic","rev",1,0,0,0,0,0,0,0,0,0,0,0,0,0,0,0,0,0
"kaggle:titanic","",396,234,111,29,205,63,19,10,0,142,202,0,2,0,2,0,0,0
"kaggle:titanic","check_function",20,6,5,2,4,2,2,0,0,2,0,2,1,0,1,0,0,0
"kaggle:titanic","fx",10,6,4,0,6,4,0,0,0,2,5,1,5,0,5,0,0,0
"kaggle:titanic","palette.match",13,11,6,3,8,2,1,2,0,6,6,0,0,0,0,0,0,0
"kaggle:titanic","bindTranslations",27,26,13,4,22,9,3,1,0,13,16,3,5,1,4,1,0,0
"kaggle:titanic","dirname",1,1,1,0,1,1,0,0,0,0,0,1,0,0,0,0,0,0
"kaggle:titanic","basename",1,1,1,0,1,1,0,0,0,0,0,1,0,0,0,0,0,0
"kaggle:titanic","packageHasNamespace",5,5,2,1,4,1,1,0,0,3,3,1,1,0,1,0,0,0
"kaggle:titanic","dir.exists",1,1,1,1,0,0,0,1,0,0,0,0,0,0,0,0,0,0
"kaggle:titanic","makeNamespace",70,52,29,13,39,15,1,12,0,24,31,1,2,2,0,1,1,0
"kaggle:titanic","asNamespace",33,27,15,4,23,10,4,0,0,13,19,3,3,0,3,0,0,0
"kaggle:titanic","file",8,8,6,0,8,5,0,0,0,3,8,0,0,0,0,0,0,0
"kaggle:titanic","environment",1,1,1,0,1,1,0,0,0,0,0,1,1,0,1,0,0,0
"kaggle:titanic","get0",6,5,5,1,4,4,0,1,0,0,0,4,3,1,2,0,1,0
"kaggle:titanic","registerS3methods",410,218,122,52,166,54,29,23,0,112,143,11,18,3,15,2,1,0
"kaggle:titanic","asNamespace",33,27,15,4,23,10,4,0,0,13,19,3,3,0,3,0,0,0
"kaggle:titanic","assign",6,4,4,1,3,3,0,1,0,0,0,3,1,0,1,0,0,0
"kaggle:titanic","setHook",38,19,10,4,15,4,1,3,0,11,11,0,2,1,1,0,1,0
"kaggle:titanic","registerS3method",81,51,31,9,42,15,6,3,0,27,36,3,11,1,10,1,0,0
"kaggle:titanic","addNamespaceDynLibs",19,18,13,6,12,5,1,5,0,7,10,1,5,1,4,1,0,0
"kaggle:titanic","runHook",24,12,6,3,9,2,2,1,0,7,3,2,5,1,4,1,0,0
"kaggle:titanic","%in%",4,4,2,1,3,1,1,0,0,2,2,1,4,1,3,1,0,0
"kaggle:titanic","match",4,4,4,2,2,1,0,2,0,1,0,1,2,2,0,0,2,0
"kaggle:titanic","%in%",4,4,2,1,3,1,1,0,0,2,2,1,4,1,3,1,0,0
"kaggle:titanic","chr",7,4,4,0,4,4,0,0,0,0,0,4,0,0,0,0,0,0
"kaggle:titanic","dots_values",13,7,7,0,7,7,0,0,0,0,4,3,0,0,0,0,0,0
"kaggle:titanic","",20,13,10,3,10,6,3,0,0,4,7,2,0,0,0,0,0,0
"kaggle:titanic","parent.env",1,1,1,1,0,0,0,1,0,0,0,0,0,0,0,0,0,0
"kaggle:titanic","parent.env",1,1,1,1,0,0,0,1,0,0,0,0,0,0,0,0,0,0
"kaggle:titanic",".mergeExportMethods",41,9,7,3,6,4,1,2,0,2,2,3,0,0,0,0,0,0
"kaggle:titanic","namespaceExport",124,74,51,19,55,25,9,10,0,30,42,7,12,1,11,1,0,0
"kaggle:titanic","list2env",14,3,3,1,2,2,0,1,0,0,1,1,0,0,0,0,0,0
"kaggle:titanic","sealNamespace",15,11,7,2,9,5,2,0,0,4,5,2,0,0,0,0,0,0
"kaggle:titanic","lockEnvironment",2,2,2,1,1,1,0,1,0,0,0,1,1,1,0,0,1,0
"kaggle:titanic","runUserHook",18,11,4,0,11,3,0,0,0,8,8,0,2,0,2,0,0,0
"kaggle:titanic","Sys.unsetenv",3,2,2,0,2,2,0,0,0,0,2,0,0,0,0,0,0,0
"kaggle:titanic","getNamespaceExports",29,22,18,4,18,6,2,2,0,12,15,2,3,0,3,0,0,0
"kaggle:titanic","parent.frame",1,1,1,1,0,0,0,1,0,0,0,0,1,1,0,0,1,0
"kaggle:titanic","dynGet",104,66,48,17,49,27,11,6,0,22,48,0,11,3,8,0,3,0
"kaggle:titanic","lazyLoadDBexec",46,36,21,7,29,15,3,4,0,14,24,3,0,0,0,0,0,0
"kaggle:titanic","lazyLoad",5,4,1,0,4,1,0,0,0,3,2,1,0,0,0,0,0,0
"kaggle:titanic","fun",11,9,7,1,8,4,0,1,0,4,7,0,0,0,0,0,0,0
"kaggle:titanic","FUN",2,2,1,0,2,1,0,0,0,1,0,1,0,0,0,0,0,0
"kaggle:titanic","delayedAssign",7,5,4,1,4,3,0,1,0,1,3,1,0,0,0,0,0,0
"kaggle:titanic","typeof",1,1,1,1,0,0,1,0,0,0,0,0,1,1,0,1,0,0
"kaggle:titanic","is.primitive",3,3,3,0,3,2,0,0,0,1,0,2,2,0,2,0,0,0
"kaggle:titanic","identical",8,8,8,0,8,8,0,0,0,0,8,0,2,0,2,0,0,0
"kaggle:titanic",".libPaths",22,1,1,1,0,0,0,1,0,0,0,0,0,0,0,0,0,0
"kaggle:titanic","getNamespaceVersion",38,22,18,5,17,6,2,3,0,11,14,2,3,0,3,0,0,0
"kaggle:titanic","",91,28,16,11,17,7,6,5,0,10,12,3,1,0,1,0,0,0
"kaggle:titanic","%||%",3,2,2,2,0,0,0,2,0,0,0,0,0,0,0,0,0,0
"kaggle:titanic","ansi_style_str",5,5,2,0,5,2,0,0,0,3,0,2,1,0,1,0,0,0
"kaggle:titanic","as.list",1,0,0,0,0,0,0,0,0,0,0,0,0,0,0,0,0,0
"kaggle:titanic","get_handlers",3,2,2,0,2,2,0,0,0,0,0,2,2,0,2,0,0,0
"kaggle:titanic","is_builtin_style",20,17,12,6,11,4,4,2,0,7,8,1,4,1,3,1,0,0
"kaggle:titanic","eval",8,7,3,1,6,2,0,1,0,4,6,0,1,1,0,0,1,0
"kaggle:titanic","create_ansi_style",94,57,29,9,48,18,4,5,0,30,41,3,12,2,10,0,2,0
"kaggle:titanic","create_ansi_style_fun",10,5,4,0,5,4,0,0,0,1,2,2,0,0,0,0,0,0
"kaggle:titanic","",40,24,15,5,19,8,5,0,0,11,10,5,4,1,3,1,0,0
"kaggle:titanic","l10n_info",0,0,0,0,0,0,0,0,0,0,0,0,0,0,0,0,0,0
"kaggle:titanic","loadedNamespaces",1,1,1,0,1,1,0,0,0,0,0,1,0,0,0,0,0,0
"kaggle:titanic","topenv",4,3,2,1,2,1,0,1,0,1,2,0,0,0,0,0,0,0
"kaggle:titanic","addNamespaceS3method",20,18,9,4,14,5,1,3,0,9,11,1,3,1,2,1,0,0
"kaggle:titanic","registerS3method",81,51,31,9,42,15,6,3,0,27,38,3,11,1,10,1,0,0
"kaggle:titanic","FUN",11,7,7,5,2,2,3,2,0,0,1,1,1,0,1,0,0,0
"kaggle:titanic",".make_numeric_version",50,31,20,12,19,8,4,7,1,11,16,2,6,4,2,0,3,1
"kaggle:titanic",".make_numeric_version",50,31,20,12,19,8,4,7,1,11,16,2,6,4,2,0,3,1
"kaggle:titanic","package_version",33,24,9,2,22,7,2,0,0,15,15,4,5,1,4,1,0,0
"kaggle:titanic","",72,26,21,4,22,10,2,2,0,12,18,0,4,0,4,0,0,0
"kaggle:titanic",".getGeneric",50,31,22,5,26,17,3,2,0,9,17,5,8,1,7,1,0,0
"kaggle:titanic","genericForBasic",13,5,5,2,3,3,0,2,0,0,2,1,0,0,0,0,0,0
"kaggle:titanic",".cacheGenericTable",64,24,21,4,20,11,2,2,0,9,20,0,2,0,2,0,0,0
"kaggle:titanic",".getMethodsTable",14,10,3,1,9,1,1,0,0,8,8,0,0,0,0,0,0,0
"kaggle:titanic","getGeneric",68,32,19,6,26,11,3,3,0,15,22,1,3,0,3,0,0,0
"kaggle:titanic","genericForBasic",13,5,5,2,3,3,0,2,0,0,2,1,0,0,0,0,0,0
"kaggle:titanic",".cacheGenericTable",64,24,21,4,20,11,2,2,0,9,20,0,2,0,2,0,0,0
"kaggle:titanic",".getMethodsTable",14,10,3,1,9,1,1,0,0,8,8,0,0,0,0,0,0,0
"kaggle:titanic","getGeneric",68,32,19,7,25,12,4,3,0,13,21,1,3,0,3,0,0,0
"kaggle:titanic","do.call",9,6,5,1,5,4,0,1,0,1,3,2,3,1,2,0,1,0
"kaggle:titanic","exists",8,6,4,1,5,3,0,1,0,2,3,2,1,1,0,0,1,0
"kaggle:titanic","environmentIsLocked",1,1,1,1,0,0,0,1,0,0,0,0,0,0,0,0,0,0
"kaggle:titanic","FUN",0,0,0,0,0,0,0,0,0,0,0,0,0,0,0,0,0,0
"kaggle:titanic","FUN",26,12,10,2,10,2,2,0,0,8,6,1,1,0,1,0,0,0
"kaggle:titanic","is_theme_element",18,9,8,1,8,1,1,0,0,7,4,1,1,0,1,0,0,0
"kaggle:titanic","%||%",3,2,2,0,2,1,0,0,0,1,2,0,0,0,0,0,0,0
"kaggle:titanic","FUN",23,14,7,3,11,2,3,0,0,9,6,1,1,0,1,0,0,0
"kaggle:titanic","is_theme_element",18,11,9,2,9,3,2,0,0,6,4,1,1,0,1,0,0,0
"kaggle:titanic","matrix",13,9,6,0,9,4,0,0,0,5,8,0,2,0,2,0,0,0
"kaggle:titanic","caller_env",3,3,1,0,3,1,0,0,0,2,2,1,0,0,0,0,0,0
"kaggle:titanic",".cacheClass",74,42,28,6,36,15,4,2,0,21,31,3,3,0,3,0,0,0
"kaggle:titanic","duplicated",1,0,0,0,0,0,0,0,0,0,0,0,0,0,0,0,0,0
"kaggle:titanic","grep",95,19,17,3,16,12,2,1,0,4,12,1,2,0,2,0,0,0
"kaggle:titanic","substring",36,18,18,8,10,4,4,4,0,6,10,0,0,0,0,0,0,0
"kaggle:titanic","",49,16,7,0,16,7,0,0,0,9,12,1,1,0,1,0,0,0
"kaggle:titanic","exists",8,6,4,1,5,3,0,1,0,2,3,2,1,1,0,0,1,0
"kaggle:titanic","setHook",38,19,10,4,15,4,1,3,0,11,11,0,2,1,1,0,1,0
"kaggle:titanic","s3_register",50,49,26,6,43,8,4,2,0,35,38,3,2,0,2,0,0,0
"kaggle:titanic","exists",8,6,4,1,5,3,0,1,0,2,3,2,1,1,0,0,1,0
"kaggle:titanic","register",31,21,7,1,20,5,1,0,0,15,16,2,2,0,2,0,0,0
"kaggle:titanic","is_namespace",3,3,2,1,2,1,1,0,0,1,0,1,0,0,0,0,0,0
"kaggle:titanic","ns_env",28,20,14,5,15,8,4,1,0,7,8,5,3,0,3,0,0,0
"kaggle:titanic","check_environment",19,7,7,1,6,2,0,1,0,4,0,2,1,0,1,0,0,0
"kaggle:titanic","get0",6,5,5,0,5,4,0,0,0,1,0,4,3,0,3,0,0,0
"kaggle:titanic","get0",6,5,5,1,4,4,0,1,0,0,0,4,3,1,2,0,1,0
"kaggle:titanic","getFunction",43,13,8,5,8,4,3,2,0,4,8,0,0,0,0,0,0,0
"kaggle:titanic","",53,10,5,2,8,2,2,0,0,6,6,0,0,0,0,0,0,0
"kaggle:titanic","isBaseFun",16,16,5,2,14,3,1,1,0,11,12,1,3,0,3,0,0,0
"kaggle:titanic","get",6,6,4,0,6,4,0,0,0,2,3,3,1,0,1,0,0,0
"kaggle:titanic","genericForBasic",13,5,5,2,3,3,0,2,0,0,2,1,2,0,2,0,0,0
"kaggle:titanic","",57,20,11,5,15,4,4,1,0,11,13,1,4,1,3,1,0,0
"kaggle:titanic","environment",1,1,1,0,1,1,0,0,0,0,0,1,1,0,1,0,0,0
"kaggle:titanic","get0",6,5,5,1,4,4,0,1,0,0,0,4,3,1,2,0,1,0
"kaggle:titanic","registerS3methods",395,203,114,52,151,47,28,24,0,104,134,9,18,3,15,2,1,0
"kaggle:titanic","asNamespace",33,27,15,4,23,10,4,0,0,13,19,3,3,0,3,0,0,0
"kaggle:titanic","library.dynam",168,74,44,13,61,27,10,3,0,34,48,7,12,1,11,1,0,0
"kaggle:titanic","assignNativeRoutines",47,35,24,7,28,13,4,3,0,15,22,2,4,2,2,0,2,0
"kaggle:titanic","runUserHook",18,12,4,0,12,3,0,0,0,9,8,0,3,0,3,0,0,0
"kaggle:titanic","isFALSE",11,8,7,5,3,1,4,1,0,2,2,0,1,1,0,0,1,0
"kaggle:titanic",".make_numeric_version",50,31,20,12,19,8,4,7,1,11,16,2,6,4,2,0,3,1
"kaggle:titanic","getRversion",35,26,10,2,24,8,2,0,0,16,15,5,5,1,4,1,0,0
"kaggle:titanic","search",0,0,0,0,0,0,0,0,0,0,0,0,0,0,0,0,0,0
"kaggle:titanic","TRAFO",1,1,1,1,0,0,0,1,0,0,0,0,0,0,0,0,0,0
"kaggle:titanic","get",6,6,4,0,6,4,0,0,0,2,2,3,4,0,4,0,0,0
"kaggle:titanic","FUN",9,9,1,1,8,0,1,0,0,8,8,0,4,0,4,0,0,0
"kaggle:titanic","TRAFO",1,1,1,0,1,1,0,0,0,0,0,1,1,0,1,0,0,0
"kaggle:titanic","strrep",10,5,5,0,5,4,0,0,0,1,2,2,1,0,1,0,0,0
"kaggle:titanic","nchar",4,4,4,1,3,1,0,1,0,2,2,1,1,0,1,0,0,0
"kaggle:titanic",".mergeImportMethods",19,5,5,1,4,2,0,1,0,2,3,1,0,0,0,0,0,0
"kaggle:titanic","",81,46,34,19,27,11,7,12,0,16,22,5,1,0,1,0,0,0
"kaggle:titanic","get",6,6,4,1,5,3,0,1,0,2,2,2,4,1,3,0,1,0
"kaggle:titanic","get0",6,5,5,1,4,4,0,1,0,0,0,4,3,1,2,0,1,0
"kaggle:titanic","getClassDef",60,38,24,1,37,21,1,0,0,16,30,5,5,0,5,0,0,0
"kaggle:titanic",".cacheClass",74,44,28,6,38,15,4,2,0,23,31,3,5,0,5,0,0,0
"kaggle:titanic",".getGenericFromCacheTable",59,10,6,2,8,3,2,0,0,5,7,1,0,0,0,0,0,0
"kaggle:titanic","getNamespace",5,3,3,0,3,2,0,0,0,1,2,1,0,0,0,0,0,0
"kaggle:titanic","get0",6,5,5,1,4,4,0,1,0,0,0,4,3,1,2,0,1,0
"kaggle:titanic","getClassDef",60,38,24,1,37,21,1,0,0,16,30,5,5,0,5,0,0,0
"kaggle:titanic","FUN",25,14,13,1,13,3,1,0,0,10,9,2,1,0,1,0,0,0
"kaggle:titanic",".identC",7,4,4,1,3,3,1,0,0,0,0,3,1,0,1,0,0,0
"kaggle:titanic","isBaseFun",17,17,14,1,16,4,1,0,0,12,13,1,6,0,6,0,0,0
"kaggle:titanic","unknown--fromConstant",9,3,3,0,3,2,0,0,0,1,2,1,0,0,0,0,0,0
"kaggle:titanic","isTRUE",11,8,7,3,5,2,3,0,0,3,3,1,1,0,1,0,0,0
"kaggle:titanic","get0",6,5,5,1,4,4,0,1,0,0,0,4,3,1,2,0,1,0
"kaggle:titanic","getClassDef",60,38,24,1,37,21,1,0,0,16,30,5,5,0,5,0,0,0
"kaggle:titanic",".requirePackage",43,12,10,3,9,6,1,2,0,3,8,1,0,0,0,0,0,0
"kaggle:titanic","getClass",16,4,3,0,4,1,0,0,0,3,3,0,1,0,1,0,0,0
"kaggle:titanic","packageSlot",3,2,2,0,2,2,0,0,0,0,0,2,2,0,2,0,0,0
"kaggle:titanic","typeof",1,1,1,0,1,1,0,0,0,0,0,1,1,0,1,0,0,0
"kaggle:titanic","",13,9,6,0,9,6,0,0,0,3,7,1,0,0,0,0,0,0
"kaggle:titanic","formals",10,3,3,0,3,2,0,0,0,1,2,1,2,0,2,0,0,0
"kaggle:titanic","formals",10,3,2,0,3,2,0,0,0,1,2,1,2,0,2,0,0,0
"kaggle:titanic","formalArgs",7,3,3,1,2,2,0,1,0,0,0,2,1,0,1,0,0,0
"kaggle:titanic","as.name",1,1,1,1,0,0,0,1,0,0,0,0,0,0,0,0,0,0
"kaggle:titanic","is.primitive",3,3,3,0,3,2,0,0,0,1,0,2,2,0,2,0,0,0
"kaggle:titanic","isFALSE",11,8,3,4,4,2,4,0,0,2,2,1,1,0,1,0,0,0
"kaggle:titanic",".getMethodsTable",14,10,3,1,9,1,1,0,0,8,8,0,0,0,0,0,0,0
"kaggle:titanic","cacheGenericsMetaData",108,54,29,7,47,15,7,0,0,32,35,7,10,0,10,0,0,0
"kaggle:titanic",".sigLabel",6,6,3,0,6,3,0,0,0,3,0,3,3,0,3,0,0,0
"kaggle:titanic",".getGeneric",50,31,22,5,26,17,3,2,0,9,17,5,9,1,8,1,0,0
"kaggle:titanic","environment",1,1,1,0,1,1,0,0,0,0,0,1,1,0,1,0,0,0
"kaggle:titanic","isTRUE",11,8,3,3,5,2,3,0,0,3,3,1,1,0,1,0,0,0
"kaggle:titanic","get0",6,5,5,1,4,4,0,1,0,0,0,4,3,1,2,0,1,0
"kaggle:titanic","isFALSE",11,8,3,4,4,2,4,0,0,2,2,1,1,0,1,0,0,0
"kaggle:titanic","isFALSE",11,8,3,4,4,2,4,0,0,2,2,1,1,0,1,0,0,0
"kaggle:titanic",".getMethodsTable",14,10,3,1,9,1,1,0,0,8,8,0,0,0,0,0,0,0
"kaggle:titanic",".getMethodsTable",14,10,4,3,7,1,3,0,0,6,6,0,0,0,0,0,0,0
"kaggle:titanic","exists",8,6,4,0,6,4,0,0,0,2,2,3,4,0,4,0,0,0
"kaggle:titanic","exists",8,6,4,0,6,4,0,0,0,2,2,3,4,0,4,0,0,0
"kaggle:titanic","getGeneric",68,32,19,6,26,13,3,3,0,13,22,1,3,0,3,0,0,0
"kaggle:titanic","getClass",16,4,1,0,4,1,0,0,0,3,3,0,1,0,1,0,0,0
"kaggle:titanic","new",11,7,5,0,7,5,0,0,0,2,5,1,3,0,3,0,0,0
"kaggle:titanic","body<-",3,1,1,0,1,1,0,0,0,0,0,1,1,0,1,0,0,0
"kaggle:titanic","formalArgs",7,3,3,1,2,2,0,1,0,0,0,2,1,0,1,0,0,0
"kaggle:titanic",".matchSigLength",93,20,12,6,14,8,4,2,0,6,10,2,3,0,3,0,0,0
"kaggle:titanic",".matchSigLength",93,20,18,6,14,8,4,2,0,6,10,2,3,0,3,0,0,0
"kaggle:titanic",".getGenericSigLength",8,5,3,2,3,1,2,0,0,2,3,0,0,0,0,0,0,0
"kaggle:titanic",".getGenericSigLength",8,5,3,2,3,1,2,0,0,2,3,0,0,0,0,0,0,0
"kaggle:titanic","as",178,88,50,15,73,29,10,5,0,44,63,6,10,0,10,0,0,0
"kaggle:titanic",".findMethodInTable",39,21,12,3,18,6,1,2,0,12,12,2,6,0,6,0,0,0
"kaggle:titanic",".classEnv",38,9,7,1,8,5,0,1,0,3,4,4,2,0,2,0,0,0
"kaggle:titanic",".duplicateClassesExist",6,4,3,1,3,0,1,0,0,3,1,0,0,0,0,0,0,0
"kaggle:titanic",".cacheMethodInTable",113,28,14,2,26,11,2,0,0,15,17,5,3,0,3,0,0,0
"kaggle:titanic","FUN",7,3,3,2,1,1,2,0,0,0,0,1,0,0,0,0,0,0
"kaggle:titanic","mget",7,5,5,1,4,4,0,1,0,0,0,4,0,0,0,0,0,0
"kaggle:titanic","packageSlot<-",3,3,3,0,3,3,0,0,0,0,2,1,1,0,1,0,0,0
"kaggle:titanic",".identC",7,4,4,1,3,3,1,0,0,0,2,1,2,0,2,0,0,0
"kaggle:titanic",".cacheGenericTable",64,24,21,4,20,11,2,2,0,9,20,0,2,0,2,0,0,0
"kaggle:titanic",".getMethodsTable",14,10,3,1,9,1,1,0,0,8,8,0,0,0,0,0,0,0
"kaggle:titanic","assign",6,6,4,0,6,4,0,0,0,2,3,3,1,0,1,0,0,0
"kaggle:titanic",".resetInheritedMethods",54,38,22,11,27,8,4,7,0,19,22,0,16,4,12,1,3,0
"kaggle:titanic",".updateMethodsInTable",106,74,41,13,61,19,7,6,0,42,55,3,4,0,4,0,0,0
"kaggle:titanic",".updateMethodsInTable",106,74,41,13,61,19,7,6,0,42,55,3,4,0,4,0,0,0
"kaggle:titanic","environment",1,1,1,0,1,1,0,0,0,0,0,1,1,0,1,0,0,0
"kaggle:titanic","isFALSE",11,8,3,4,4,2,4,0,0,2,2,1,1,0,1,0,0,0
"kaggle:titanic",".getMethodsTable",14,10,3,1,9,1,1,0,0,8,8,0,0,0,0,0,0,0
"kaggle:titanic","assign",6,6,4,0,6,4,0,0,0,2,3,3,1,0,1,0,0,0
"kaggle:titanic",".resetInheritedMethods",54,38,22,12,26,7,4,8,0,19,21,0,16,4,12,1,3,0
"kaggle:titanic","",27,4,4,1,3,3,1,0,0,0,2,1,2,0,2,0,0,0
"kaggle:titanic","dispatchIsInternal",11,7,6,1,6,2,1,0,0,4,1,2,4,0,4,0,0,0
"kaggle:titanic",".cacheGeneric",4,4,1,0,4,1,0,0,0,3,2,0,0,0,0,0,0,0
"kaggle:titanic",".cacheGenericTable",64,24,15,4,20,11,2,2,0,9,20,0,2,0,2,0,0,0
"kaggle:titanic",".getMethodsTable",14,10,3,1,9,1,1,0,0,8,8,0,0,0,0,0,0,0
"kaggle:titanic","is.primitive",3,3,3,0,3,2,0,0,0,1,0,2,2,0,2,0,0,0
"kaggle:titanic","logical",1,1,1,0,1,1,0,0,0,0,0,1,1,0,1,0,0,0
"kaggle:titanic","lastEnv",13,13,10,2,11,2,2,0,0,9,10,0,3,0,3,0,0,0
"kaggle:titanic","parent.env",1,1,1,1,0,0,0,1,0,0,0,0,0,0,0,0,0,0
"kaggle:titanic","getFunction",44,32,22,10,22,11,9,1,0,11,17,2,4,1,3,0,1,0
"kaggle:titanic","FUN",11,9,6,0,9,3,0,0,0,6,2,2,4,0,4,0,0,0
"kaggle:titanic","parent.env",1,1,1,0,1,1,0,0,0,0,0,1,1,0,1,0,0,0
"kaggle:titanic","parent.env",1,1,1,1,0,0,0,1,0,0,0,0,1,1,0,0,1,0
"kaggle:titanic","getFunction",44,32,22,11,21,10,9,2,0,11,16,2,4,1,3,0,1,0
"kaggle:titanic","parent.env",1,1,1,0,1,1,0,0,0,0,0,1,1,0,1,0,0,0
"kaggle:titanic","parent.env",1,1,1,1,0,0,0,1,0,0,0,0,1,1,0,0,1,0
"kaggle:titanic","getFunction",44,32,22,10,22,11,9,1,0,11,17,2,4,1,3,0,1,0
"kaggle:titanic","FUN",18,9,9,2,7,7,1,1,0,0,7,0,0,0,0,0,0,0
"kaggle:titanic",".getNamespace",1,1,1,1,0,0,0,1,0,0,0,0,0,0,0,0,0,0
"kaggle:titanic","is.unit",5,5,4,1,4,1,1,0,0,3,0,1,1,0,1,0,0,0
"kaggle:titanic","numnotnull",27,5,2,1,4,1,1,0,0,3,0,1,0,0,0,0,0,0
"kaggle:titanic","checkNA",44,5,2,1,4,1,1,0,0,3,0,1,0,0,0,0,0,0
"kaggle:titanic","unit",52,24,21,8,16,10,6,2,0,6,9,4,1,0,1,0,0,0
"kaggle:titanic","textGrob",44,33,12,3,30,7,3,0,0,23,23,3,1,0,1,0,0,0
"kaggle:titanic","validGrob",1,0,0,0,0,0,0,0,0,0,0,0,0,0,0,0,0,0
"kaggle:titanic","gpar",5,3,2,0,3,2,0,0,0,1,2,1,0,0,0,0,0,0
"kaggle:titanic","validGP",265,58,28,14,44,14,14,0,0,30,35,3,4,1,3,1,0,0
"kaggle:titanic","modifyList",153,33,25,17,16,6,6,11,0,10,15,1,22,9,13,4,5,0
"kaggle:titanic","exists",8,6,4,1,5,3,0,1,0,2,2,2,4,1,3,0,1,0
"kaggle:titanic","registerS3method",116,72,41,10,62,24,8,2,0,38,54,6,20,1,19,1,0,0
"kaggle:titanic","FUN",3,1,1,1,0,0,1,0,0,0,0,0,0,0,0,0,0,0
"kaggle:titanic","FUN",3,1,1,1,0,0,1,0,0,0,0,0,0,0,0,0,0,0
"kaggle:titanic","get0",6,5,5,1,4,4,0,1,0,0,0,4,3,1,2,0,1,0
"kaggle:titanic","getClassDef",60,38,24,1,37,21,1,0,0,16,30,5,5,0,5,0,0,0
"kaggle:titanic",".cacheClass",74,44,28,10,34,17,8,2,0,17,28,4,5,0,5,0,0,0
"kaggle:titanic",".cacheClass",74,44,28,10,34,17,8,2,0,17,28,4,5,0,5,0,0,0
"kaggle:titanic",".recacheSubclasses",129,59,39,17,42,16,8,9,0,26,42,0,9,3,6,1,2,0
"kaggle:titanic","sort.list",84,34,28,13,21,11,6,7,0,10,20,1,0,0,0,0,0,0
"kaggle:titanic","rep_len",2,2,2,2,0,0,2,0,0,0,0,0,0,0,0,0,0,0
"kaggle:titanic","packageSlot",3,2,2,0,2,2,0,0,0,0,0,2,2,0,2,0,0,0
"kaggle:titanic","get",6,6,4,1,5,3,0,1,0,2,1,3,4,1,3,0,1,0
"kaggle:titanic","exists",8,6,4,1,5,3,0,1,0,2,1,3,4,1,3,0,1,0
"kaggle:titanic",".mergeMethodsTable",409,72,59,25,47,26,12,13,0,21,43,2,7,0,7,0,0,0
"kaggle:titanic","initialize",55,15,11,1,14,4,1,0,0,10,14,0,6,0,6,0,0,0
"kaggle:titanic",".allowPrimitiveMethods",6,4,4,3,1,1,2,1,0,0,0,1,0,0,0,0,0,0
"kaggle:titanic","isFALSE",11,8,3,4,4,2,4,0,0,2,2,1,1,0,1,0,0,0
"kaggle:titanic",".getMethodsTable",14,10,3,1,9,1,1,0,0,8,8,0,0,0,0,0,0,0
"kaggle:titanic","cacheGenericsMetaData",108,54,29,7,47,17,7,0,0,30,35,8,10,0,10,0,0,0
"kaggle:titanic",".newOrMultipleMethod",74,2,2,1,1,1,1,0,0,0,0,1,0,0,0,0,0,0
"kaggle:titanic",".mergeMethodsTable",409,85,69,31,54,28,14,17,0,26,50,2,11,3,8,0,3,0
"kaggle:titanic",".newOrMultipleMethod",74,2,2,1,1,1,1,0,0,0,0,1,0,0,0,0,0,0
"kaggle:titanic","isFALSE",11,8,3,4,4,2,4,0,0,2,2,1,1,0,1,0,0,0
"kaggle:titanic",".getMethodsTable",14,10,3,1,9,1,1,0,0,8,8,0,0,0,0,0,0,0
"kaggle:titanic","getGeneric",68,32,19,6,26,13,3,3,0,13,22,1,5,1,4,0,1,0
"kaggle:titanic","isFALSE",11,8,7,4,4,2,4,0,0,2,2,1,1,0,1,0,0,0
"kaggle:titanic",".class1",10,6,6,2,4,2,1,1,0,2,2,2,1,0,1,0,0,0
"kaggle:titanic","body<-",3,1,1,0,1,1,0,0,0,0,0,1,1,0,1,0,0,0
"kaggle:titanic","environment",1,1,1,0,1,1,0,0,0,0,0,1,1,0,1,0,0,0
"kaggle:titanic","isTRUE",11,8,3,3,5,2,3,0,0,3,3,1,1,0,1,0,0,0
"kaggle:titanic","isFALSE",11,8,3,4,4,2,4,0,0,2,2,1,1,0,1,0,0,0
"kaggle:titanic","isFALSE",11,8,3,4,4,2,4,0,0,2,2,1,1,0,1,0,0,0
"kaggle:titanic","getClassDef",60,38,24,1,37,21,1,0,0,16,30,5,5,0,5,0,0,0
"kaggle:titanic",".getMethodsTable",14,10,3,1,9,1,1,0,0,8,8,0,0,0,0,0,0,0
"kaggle:titanic","exists",8,6,4,0,6,4,0,0,0,2,2,3,4,0,4,0,0,0
"kaggle:titanic","body<-",3,1,1,0,1,1,0,0,0,0,0,1,1,0,1,0,0,0
"kaggle:titanic","formalArgs",7,3,3,1,2,2,0,1,0,0,0,2,1,0,1,0,0,0
"kaggle:titanic",".quickCoerceSelect",38,11,4,1,10,2,0,1,0,8,7,0,3,0,3,0,0,0
"kaggle:titanic",".matchSigLength",93,20,18,6,14,8,4,2,0,6,10,2,3,0,3,0,0,0
"kaggle:titanic",".getGenericSigLength",8,5,3,2,3,1,2,0,0,2,3,0,0,0,0,0,0,0
"kaggle:titanic","as",131,73,43,14,59,24,10,4,0,35,55,4,9,0,9,0,0,0
"kaggle:titanic",".classEnv",38,16,12,2,14,7,0,2,0,7,11,3,4,0,4,0,0,0
"kaggle:titanic",".cacheMethodInTable",113,28,14,2,26,11,2,0,0,15,17,5,3,0,3,0,0,0
"kaggle:titanic",".classEnv",38,16,12,2,14,7,0,2,0,7,11,3,4,0,4,0,0,0
"kaggle:titanic","isFALSE",11,8,3,4,4,2,4,0,0,2,2,1,1,0,1,0,0,0
"kaggle:titanic",".getMethodsTable",14,10,3,1,9,1,1,0,0,8,8,0,0,0,0,0,0,0
"kaggle:titanic","getGeneric",68,32,19,6,26,13,3,3,0,13,22,1,5,1,4,0,1,0
"kaggle:titanic","environment",1,1,1,0,1,1,0,0,0,0,0,1,1,0,1,0,0,0
"kaggle:titanic","isFALSE",11,8,3,4,4,2,4,0,0,2,2,1,1,0,1,0,0,0
"kaggle:titanic",".getMethodsTable",14,10,3,1,9,1,1,0,0,8,8,0,0,0,0,0,0,0
"kaggle:titanic",".checkGroupSigLength",194,82,69,36,46,22,20,16,0,24,42,3,3,1,2,0,1,0
"kaggle:titanic","getGroupMembers",38,25,12,3,22,7,2,1,0,15,20,1,2,0,2,0,0,0
"kaggle:titanic","getGeneric",68,32,19,7,25,12,4,3,0,13,21,1,5,1,4,0,1,0
"kaggle:titanic","isFALSE",11,8,3,4,4,2,4,0,0,2,2,1,1,0,1,0,0,0
"kaggle:titanic",".getMethodsTable",14,10,3,1,9,1,1,0,0,8,8,0,0,0,0,0,0,0
"kaggle:titanic","getGeneric",68,32,19,6,26,13,3,3,0,13,22,1,5,1,4,0,1,0
"kaggle:titanic","checkTrace",9,3,2,1,2,1,1,0,0,1,2,0,0,0,0,0,0,0
"kaggle:titanic","match",4,4,4,1,3,1,0,1,0,2,0,1,2,1,1,0,1,0
"kaggle:titanic","getDataPart",103,22,17,6,16,8,3,3,0,8,12,2,1,0,1,0,0,0
"kaggle:titanic","asMethod",9,4,4,0,4,3,0,0,0,1,2,2,0,0,0,0,0,0
"kaggle:titanic",".class1",10,6,6,2,4,2,1,1,0,2,2,2,1,0,1,0,0,0
"kaggle:titanic","isFALSE",11,8,3,4,4,2,4,0,0,2,2,1,1,0,1,0,0,0
"kaggle:titanic","genericForBasic",13,7,7,3,4,4,1,2,0,0,3,1,2,0,2,0,0,0
"kaggle:titanic","environment",1,1,1,0,1,1,0,0,0,0,0,1,1,0,1,0,0,0
"kaggle:titanic","isTRUE",11,8,3,3,5,2,3,0,0,3,3,1,1,0,1,0,0,0
"kaggle:titanic","isFALSE",11,8,3,4,4,2,4,0,0,2,2,1,1,0,1,0,0,0
"kaggle:titanic",".getMethodsTable",14,10,3,1,9,1,1,0,0,8,8,0,0,0,0,0,0,0
"kaggle:titanic","exists",8,6,4,0,6,4,0,0,0,2,2,3,4,0,4,0,0,0
"kaggle:titanic","body<-",3,1,1,0,1,1,0,0,0,0,0,1,1,0,1,0,0,0
"kaggle:titanic","formalArgs",7,3,3,1,2,2,0,1,0,0,0,2,1,0,1,0,0,0
"kaggle:titanic",".matchSigLength",93,20,18,6,14,8,4,2,0,6,10,2,3,0,3,0,0,0
"kaggle:titanic",".getGenericSigLength",8,5,3,2,3,1,2,0,0,2,3,0,0,0,0,0,0,0
"kaggle:titanic","as",131,73,43,14,59,24,10,4,0,35,55,4,9,0,9,0,0,0
"kaggle:titanic",".cacheMethodInTable",113,28,14,2,26,11,2,0,0,15,17,5,3,0,3,0,0,0
"kaggle:titanic",".getGenericFromCache",5,4,1,0,4,1,0,0,0,3,0,1,1,0,1,0,0,0
"kaggle:titanic",".getGenericFromCacheTable",59,10,5,2,8,3,2,0,0,5,7,1,0,0,0,0,0,0
"kaggle:titanic","assign",6,6,4,0,6,4,0,0,0,2,3,3,1,0,1,0,0,0
"kaggle:titanic","isFALSE",11,8,3,4,4,2,4,0,0,2,2,1,1,0,1,0,0,0
"kaggle:titanic","genericForBasic",13,7,7,3,4,4,1,2,0,0,3,1,2,0,2,0,0,0
"kaggle:titanic","parent.env",1,1,1,0,1,1,0,0,0,0,0,1,1,0,1,0,0,0
"kaggle:titanic",".getMethodsTable",14,10,3,1,9,1,1,0,0,8,8,0,0,0,0,0,0,0
"kaggle:titanic","getFunction",44,32,22,11,21,10,9,2,0,11,16,2,4,1,3,0,1,0
"kaggle:titanic","getFunction",44,32,22,11,21,10,9,2,0,11,16,2,4,1,3,0,1,0
"kaggle:titanic","implicitGeneric",208,102,61,19,83,26,8,11,0,57,71,5,14,2,12,1,1,0
"kaggle:titanic",".genericOrImplicit",42,27,15,3,24,7,2,1,0,17,16,2,3,0,3,0,0,0
"kaggle:titanic","assign",6,6,4,1,5,3,0,1,0,2,3,2,1,0,1,0,0,0
"kaggle:titanic","bindingIsLocked",8,7,7,1,6,4,0,1,0,2,3,2,0,0,0,0,0,0
"kaggle:titanic",".assignOverBinding",62,31,21,5,26,9,5,0,0,17,25,1,2,0,2,0,0,0
"kaggle:titanic","environment",1,1,1,0,1,1,0,0,0,0,0,1,1,0,1,0,0,0
"kaggle:titanic",".getMethodsTable",14,10,3,1,9,1,1,0,0,8,8,0,0,0,0,0,0,0
"kaggle:titanic",".checkGroupSigLength",194,82,69,37,45,22,20,17,0,23,41,3,3,1,2,0,1,0
"kaggle:titanic","getGroupMembers",38,25,12,3,22,7,2,1,0,15,20,1,2,0,2,0,0,0
"kaggle:titanic","getPackageName",93,7,6,0,7,4,0,0,0,3,6,1,0,0,0,0,0,0
"kaggle:titanic","get0",6,5,5,1,4,4,0,1,0,0,0,4,3,1,2,0,1,0
"kaggle:titanic","isFALSE",11,8,7,4,4,2,4,0,0,2,2,1,1,0,1,0,0,0
"kaggle:titanic","ifelse",105,37,35,19,18,11,12,7,0,7,12,4,23,13,10,6,7,0
"kaggle:titanic",".NamespaceOrPackage",20,9,7,1,8,4,0,1,0,4,6,1,0,0,0,0,0,0
"kaggle:titanic","parent.env<-",2,2,2,0,2,2,0,0,0,0,2,0,0,0,0,0,0,0
"kaggle:titanic",".asGroupArgument",9,3,3,0,3,2,0,0,0,1,2,1,0,0,0,0,0,0
"kaggle:titanic","get",6,6,4,1,5,3,0,1,0,2,1,3,4,1,3,0,1,0
"kaggle:titanic","exists",8,6,4,1,5,3,0,1,0,2,1,3,4,1,3,0,1,0
"kaggle:titanic","assign",6,6,4,0,6,4,0,0,0,2,3,3,1,0,1,0,0,0
"kaggle:titanic",".resetInheritedMethods",54,38,22,12,26,7,4,8,0,19,21,0,16,4,12,1,3,0
"kaggle:titanic",".mlistAddToTable",29,19,10,4,15,5,4,0,0,10,13,1,0,0,0,0,0,0
"kaggle:titanic",".setupMethodsTables",75,22,9,1,21,8,1,0,0,13,18,0,0,0,0,0,0,0
"kaggle:titanic",".storeMlist",141,25,19,9,16,6,4,5,0,10,16,0,0,0,0,0,0,0
"kaggle:titanic","generic.skeleton",42,21,14,4,17,8,2,2,0,9,14,1,0,0,0,0,0,0
"kaggle:titanic",".mergeMethodsTable",335,83,67,30,53,27,13,17,0,26,50,1,11,3,8,0,3,0
"kaggle:titanic",".newOrMultipleMethod",74,2,2,1,1,1,1,0,0,0,0,1,0,0,0,0,0,0
"kaggle:titanic",".sigLabel",6,6,3,0,6,3,0,0,0,3,0,3,3,0,3,0,0,0
"kaggle:titanic","is.primitive",2,2,2,0,2,2,0,0,0,0,0,2,1,0,1,0,0,0
"kaggle:titanic",".resetTable",179,78,34,10,68,16,7,3,0,52,54,7,11,0,11,0,0,0
"kaggle:titanic",".getMethodsTable",14,10,4,2,8,2,2,0,0,6,7,0,0,0,0,0,0,0
"kaggle:titanic","getMethodsForDispatch",5,4,1,0,4,1,0,0,0,3,2,0,0,0,0,0,0,0
"kaggle:titanic",".getMethodsTable",14,10,3,1,9,1,1,0,0,8,8,0,0,0,0,0,0,0
"kaggle:titanic",".getMethodsTable",14,10,4,2,8,2,2,0,0,6,7,0,0,0,0,0,0,0
"kaggle:titanic",".matchSigLength",93,20,18,6,14,8,4,2,0,6,10,2,3,0,3,0,0,0
"kaggle:titanic",".getGenericSigLength",8,5,3,2,3,1,2,0,0,2,3,0,0,0,0,0,0,0
"kaggle:titanic","getMethodsForDispatch",5,4,1,0,4,1,0,0,0,3,2,0,0,0,0,0,0,0
"kaggle:titanic","as<-",146,49,29,6,43,19,3,3,0,24,36,7,7,0,7,0,0,0
"kaggle:titanic",".getMethodsTable",14,10,3,1,9,1,1,0,0,8,8,0,0,0,0,0,0,0
"kaggle:titanic",".matchSigLength",93,20,18,6,14,8,4,2,0,6,10,2,3,0,3,0,0,0
"kaggle:titanic",".getGenericSigLength",8,5,3,2,3,1,2,0,0,2,3,0,0,0,0,0,0,0
"kaggle:titanic","as<-",146,49,29,6,43,19,3,3,0,24,36,7,7,0,7,0,0,0
"kaggle:titanic","asMethod",4,4,4,0,4,4,0,0,0,0,3,1,0,0,0,0,0,0
"kaggle:titanic","environment",1,1,1,0,1,1,0,0,0,0,0,1,1,0,1,0,0,0
"kaggle:titanic","isTRUE",11,8,3,3,5,2,3,0,0,3,3,1,1,0,1,0,0,0
"kaggle:titanic","isFALSE",11,8,3,4,4,2,4,0,0,2,2,1,1,0,1,0,0,0
"kaggle:titanic",".getMethodsTable",14,10,3,1,9,1,1,0,0,8,8,0,0,0,0,0,0,0
"kaggle:titanic","body<-",3,1,1,0,1,1,0,0,0,0,0,1,1,0,1,0,0,0
"kaggle:titanic","formalArgs",7,3,3,1,2,2,0,1,0,0,0,2,1,0,1,0,0,0
"kaggle:titanic",".matchSigLength",93,20,18,6,14,8,4,2,0,6,10,2,3,0,3,0,0,0
"kaggle:titanic",".getGenericSigLength",8,5,3,2,3,1,2,0,0,2,3,0,0,0,0,0,0,0
"kaggle:titanic","as",131,73,43,14,59,24,10,4,0,35,55,4,9,0,9,0,0,0
"kaggle:titanic",".cacheMethodInTable",113,28,14,2,26,11,2,0,0,15,17,5,3,0,3,0,0,0
"kaggle:titanic","ifelse",105,37,35,19,18,11,12,7,0,7,12,4,23,13,10,6,7,0
"kaggle:titanic","FUN",3,3,1,1,2,0,1,0,0,2,0,0,0,0,0,0,0,0
"kaggle:titanic","exists",8,6,4,1,5,3,0,1,0,2,2,2,4,1,3,0,1,0
"kaggle:titanic","FUN",4,4,1,1,3,0,1,0,0,3,0,0,1,0,1,0,0,0
"kaggle:titanic","",83,49,34,10,39,16,6,4,0,23,32,1,6,0,6,0,0,0
"kaggle:titanic","unknown--fromConstant",45,18,16,4,14,10,2,2,0,4,10,1,5,0,5,0,0,0
"kaggle:titanic","as.list",1,0,0,0,0,0,0,0,0,0,0,0,0,0,0,0,0,0
"kaggle:titanic",".mergeImportMethods",19,13,9,5,8,3,0,5,0,5,7,1,3,1,2,0,1,0
"kaggle:titanic","",61,26,21,9,17,10,9,0,0,7,17,0,0,0,0,0,0,0
"kaggle:titanic",".getMethodsTable",14,10,3,1,9,1,1,0,0,8,8,0,0,0,0,0,0,0
"kaggle:titanic","getGeneric",68,32,19,7,25,12,4,3,0,13,21,1,5,1,4,0,1,0
"kaggle:titanic","",61,37,24,9,28,13,9,0,0,15,28,0,0,0,0,0,0,0
"kaggle:titanic","genericPackage",10,4,3,1,3,2,1,0,0,1,0,2,0,0,0,0,0,0
"kaggle:titanic","is.primitive",2,2,2,0,2,2,0,0,0,0,0,2,1,0,1,0,0,0
"kaggle:titanic","parent.env",1,1,1,0,1,1,0,0,0,0,0,1,1,0,1,0,0,0
"kaggle:titanic","getFunction",43,31,18,10,21,11,9,1,0,10,18,1,4,0,4,0,0,0
"kaggle:titanic","",64,29,18,7,22,9,6,1,0,13,19,2,10,1,9,1,0,0
"kaggle:titanic","environment",1,1,1,0,1,1,0,0,0,0,0,1,1,0,1,0,0,0
"kaggle:titanic","get0",6,5,5,1,4,4,0,1,0,0,0,4,3,1,2,0,1,0
"kaggle:titanic","registerS3methods",395,227,118,56,171,47,32,24,0,124,154,9,29,4,25,2,2,0
"kaggle:titanic","asNamespace",33,27,15,4,23,10,4,0,0,13,19,3,3,0,3,0,0,0
"kaggle:titanic","registerS3method",116,72,41,10,62,24,8,2,0,38,54,6,20,1,19,1,0,0
"kaggle:titanic","lazyLoadDBexec",46,36,21,6,30,16,2,4,0,14,24,4,1,0,1,0,0,0
"kaggle:titanic","lazyLoad",5,4,1,0,4,1,0,0,0,3,2,1,0,0,0,0,0,0
"kaggle:titanic","environmentName",1,1,1,1,0,0,0,1,0,0,0,0,0,0,0,0,0,0
"kaggle:titanic",".registerS3method",83,60,31,11,49,17,3,8,0,32,40,6,8,1,7,0,1,0
"kaggle:titanic","get0",6,5,5,1,4,4,0,1,0,0,0,4,3,1,2,0,1,0
"kaggle:titanic","getDLLRegisteredRoutines.DLLInfo",16,10,9,1,9,5,1,0,0,4,6,1,1,0,1,0,0,0
"kaggle:titanic","gzfile",5,5,4,0,5,4,0,0,0,1,4,1,0,0,0,0,0,0
"kaggle:titanic","force",1,1,1,0,1,1,0,0,0,0,0,1,1,0,1,0,0,0
"kaggle:titanic","eval",8,7,3,1,6,2,0,1,0,4,6,0,1,1,0,0,1,0
"kaggle:titanic","force",1,1,1,1,0,0,1,0,0,0,0,0,1,1,0,1,0,0
"kaggle:titanic","label",5,5,4,0,5,1,0,0,0,4,4,0,3,0,3,0,0,0
"kaggle:titanic","",13,9,6,0,9,6,0,0,0,3,7,1,0,0,0,0,0,0
"kaggle:titanic","is.primitive",2,2,2,0,2,2,0,0,0,0,0,2,1,0,1,0,0,0
"kaggle:titanic","namespaceImportFrom",518,228,147,61,167,73,38,23,0,94,148,11,31,5,26,3,2,0
"kaggle:titanic","anyDuplicated",1,0,0,0,0,0,0,0,0,0,0,0,0,0,0,0,0,0
"kaggle:titanic","getNamespaceExports",29,22,18,4,18,6,2,2,0,12,14,2,4,0,4,0,0,0
"kaggle:titanic","importIntoEnv",90,33,22,3,30,17,2,1,0,13,24,4,7,1,6,1,0,0
"kaggle:titanic","parent.env",1,1,1,0,1,1,0,0,0,0,0,1,1,0,1,0,0,0
"kaggle:titanic","asNamespace",33,27,15,4,23,10,4,0,0,13,19,3,3,0,3,0,0,0
"kaggle:titanic",".getMethodsTable",14,10,3,1,9,1,1,0,0,8,8,0,0,0,0,0,0,0
"kaggle:titanic","",64,29,18,7,22,9,6,1,0,13,19,2,10,1,9,1,0,0
"kaggle:titanic",".mergeImportMethods",19,13,8,5,8,3,0,5,0,5,7,1,3,1,2,0,1,0
"kaggle:titanic",".mergeImportMethods",19,13,8,6,7,2,0,6,0,5,6,1,3,1,2,0,1,0
"kaggle:titanic","",61,37,24,9,28,13,9,0,0,15,28,0,0,0,0,0,0,0
"kaggle:titanic","lazyLoadDBexec",46,36,24,6,30,16,2,4,0,14,24,4,1,0,1,0,0,0
"kaggle:titanic","assignNativeRoutines",47,36,25,7,29,14,4,3,0,15,22,3,5,2,3,0,2,0
"kaggle:titanic","getNativeSymbolInfo",31,19,17,4,15,11,2,2,0,4,10,3,1,0,1,0,0,0
"kaggle:titanic","same.isFn",21,15,10,0,15,9,0,0,0,6,6,4,9,0,9,0,0,0
"kaggle:titanic","intToUtf8",3,3,2,0,3,1,0,0,0,2,2,1,0,0,0,0,0,0
"kaggle:titanic","conditionMessage",1,0,0,0,0,0,0,0,0,0,0,0,0,0,0,0,0,0
"kaggle:titanic","not.Ident",18,12,9,0,12,9,0,0,0,3,6,4,8,0,8,0,0,0
"kaggle:titanic","stderr",0,0,0,0,0,0,0,0,0,0,0,0,0,0,0,0,0,0
"kaggle:titanic",".packageStartupMessage",60,28,20,8,20,11,4,4,0,9,15,1,6,2,4,0,2,0
"kaggle:titanic","withOneRestart",8,2,0,0,2,0,0,0,0,2,0,0,0,0,0,0,0,0
"kaggle:titanic","doWithOneRestart",6,2,2,0,2,1,0,0,0,1,1,1,0,0,0,0,0,0
"kaggle:titanic","conditionCall",1,0,0,0,0,0,0,0,0,0,0,0,0,0,0,0,0,0
"kaggle:titanic","conditionMessage",1,0,0,0,0,0,0,0,0,0,0,0,0,0,0,0,0,0
"kaggle:titanic","signalCondition",14,12,11,3,9,6,1,2,0,3,6,1,1,0,1,0,0,0
"kaggle:titanic","defaultHandler",29,12,10,0,12,4,0,0,0,8,5,3,0,0,0,0,0,0
"kaggle:titanic","as_function",61,6,5,2,4,3,2,0,0,1,2,2,3,0,3,0,0,0
"kaggle:titanic","FUN",3,3,1,0,3,1,0,0,0,2,0,1,1,0,1,0,0,0
"kaggle:titanic","FUN",6,3,3,1,2,2,1,0,0,0,0,2,1,1,0,1,0,0
"kaggle:titanic","FUN",3,3,1,0,3,1,0,0,0,2,0,1,1,0,1,0,0,0
"kaggle:titanic","FUN",6,3,3,1,2,2,1,0,0,0,0,2,1,1,0,1,0,0
"kaggle:titanic","pmatch",8,6,6,2,4,4,1,1,0,0,3,1,0,0,0,0,0,0
"kaggle:titanic","exists",8,6,4,0,6,4,0,0,0,2,2,3,4,0,4,0,0,0
"kaggle:titanic","FUN",3,3,1,0,3,1,0,0,0,2,0,1,1,0,1,0,0,0
"kaggle:titanic","stdout",0,0,0,0,0,0,0,0,0,0,0,0,0,0,0,0,0,0
"kaggle:titanic","FUN",3,3,1,0,3,1,0,0,0,2,0,1,1,0,1,0,0,0
"kaggle:titanic","FUN",3,3,1,0,3,1,0,0,0,2,0,1,1,0,1,0,0,0
"kaggle:titanic","modifyList",153,61,39,21,40,16,4,17,0,24,38,2,24,6,18,2,4,0
"kaggle:titanic","modifyList",153,61,39,21,40,16,4,17,0,24,38,2,24,6,18,2,4,0
"kaggle:titanic","FUN",3,3,1,0,3,1,0,0,0,2,0,1,1,0,1,0,0,0
"kaggle:titanic","nchar",4,4,4,3,1,0,1,2,0,1,1,0,1,1,0,0,1,0
"kaggle:titanic","mode",17,10,10,1,9,5,0,1,1,4,8,0,5,1,4,0,1,1
"kaggle:titanic","FUN",3,3,1,0,3,1,0,0,0,2,0,1,1,0,1,0,0,0
"kaggle:titanic","sub",45,18,16,4,14,10,2,2,0,4,10,1,2,0,2,0,0,0
"kaggle:titanic","FUN",3,3,1,0,3,1,0,0,0,2,0,1,1,0,1,0,0,0
"kaggle:titanic","match.arg",77,53,42,15,38,16,10,5,0,22,32,0,5,0,5,0,0,0
"kaggle:titanic","FUN",3,3,1,0,3,1,0,0,0,2,0,1,1,0,1,0,0,0
"kaggle:titanic","do.call",9,9,6,1,8,5,0,1,0,3,5,2,3,1,2,0,1,0
"kaggle:titanic","formals",10,5,3,0,5,3,0,0,0,2,2,1,2,0,2,0,0,0
"kaggle:titanic","FUN",3,3,1,0,3,1,0,0,0,2,0,1,1,0,1,0,0,0
"kaggle:titanic","strOptions",17,9,3,0,9,2,0,0,0,7,5,1,0,0,0,0,0,0
"kaggle:titanic","%||%",3,2,2,2,0,0,1,1,0,0,0,0,0,0,0,0,0,0
"kaggle:titanic","",8,5,4,1,4,1,1,0,0,3,0,1,2,0,2,0,0,0
"kaggle:titanic","substr",13,7,7,3,4,4,2,1,0,0,3,1,0,0,0,0,0,0
"kaggle:titanic","nchar.w",6,6,6,1,5,1,0,1,0,4,2,1,3,1,2,0,1,0
"kaggle:titanic","FUN",3,3,1,0,3,1,0,0,0,2,0,1,1,0,1,0,0,0
"kaggle:titanic","FUN",3,3,1,0,3,1,0,0,0,2,0,1,1,0,1,0,0,0
"kaggle:titanic","FUN",11,10,7,3,7,1,0,3,0,6,6,0,1,0,1,0,0,0
"kaggle:titanic","is_string",7,4,4,1,3,3,1,0,0,0,0,3,1,0,1,0,0,0
"kaggle:titanic","is_quosure",5,5,4,1,4,1,1,0,0,3,0,1,1,0,1,0,0,0
"kaggle:titanic","substring",36,18,18,7,11,5,4,3,0,6,11,0,0,0,0,0,0,0
"kaggle:titanic","strsplit",7,6,4,3,3,1,1,2,0,2,3,0,1,1,0,0,1,0
"kaggle:titanic","eval",8,7,3,1,6,2,1,0,0,4,5,1,2,1,1,1,0,0
"kaggle:titanic","environment",1,1,1,0,1,1,0,0,0,0,0,1,1,0,1,0,0,0
"kaggle:titanic","as.vector",2,2,2,0,2,1,0,0,0,1,0,1,1,0,1,0,0,0
"kaggle:titanic","enexpr",9,4,4,0,4,4,0,0,0,0,0,4,0,0,0,0,0,0
"kaggle:titanic","make_proto_method",29,16,11,2,14,7,1,1,0,7,6,5,0,0,0,0,0,0
"kaggle:titanic","as.vector",2,2,2,1,1,0,1,0,0,1,0,0,1,1,0,1,0,0
"kaggle:titanic","is_missing",10,10,9,1,9,1,1,0,0,8,8,0,3,0,3,0,0,0
"kaggle:titanic","list2env",14,3,3,0,3,2,0,0,0,1,2,1,0,0,0,0,0,0
"kaggle:titanic","eval",8,7,3,1,6,2,1,0,0,4,5,1,2,1,1,1,0,0
"kaggle:titanic","super",3,3,2,0,3,2,0,0,0,1,0,2,0,0,0,0,0,0
"kaggle:titanic","duplicated",1,0,0,0,0,0,0,0,0,0,0,0,0,0,0,0,0,0
"kaggle:titanic","new.env",4,4,3,3,1,0,1,2,0,1,0,0,2,2,0,0,2,0
"kaggle:titanic","ggproto",70,30,22,7,23,10,5,2,0,13,14,3,8,3,5,1,2,0
"kaggle:titanic","unknown--fromConstant",5,3,3,0,3,3,0,0,0,0,0,3,1,0,1,0,0,0
"kaggle:titanic","match.fun",40,15,12,3,12,8,2,1,0,4,11,1,2,1,1,1,0,0
"kaggle:titanic","get",6,6,4,1,5,3,0,1,0,2,2,2,4,1,3,0,1,0
"kaggle:titanic","check_fun",5,5,4,1,4,1,1,0,0,3,0,1,1,0,1,0,0,0
"kaggle:titanic","duplicated",1,0,0,0,0,0,0,0,0,0,0,0,0,0,0,0,0,0
"kaggle:titanic","merge_vectors",28,21,21,11,10,9,3,8,0,1,9,1,13,7,6,1,6,0
"kaggle:titanic","FUN",6,5,5,1,4,4,0,1,0,0,2,2,0,0,0,0,0,0
"kaggle:titanic","",3,3,2,0,3,2,0,0,0,1,2,0,0,0,0,0,0,0
"kaggle:titanic","unit",52,24,22,8,16,12,5,3,0,4,9,4,7,2,5,1,1,0
"kaggle:titanic","maybe_missing",15,15,12,2,13,3,2,0,0,10,12,0,5,0,5,0,0,0
"kaggle:titanic","is_missing",10,10,9,1,9,1,1,0,0,8,8,0,3,0,3,0,0,0
"kaggle:titanic","missing_arg",3,2,2,0,2,2,0,0,0,0,0,2,0,0,0,0,0,0
"kaggle:titanic","",13,13,10,2,11,1,2,0,0,10,10,0,3,0,3,0,0,0
"kaggle:titanic","deprecated",4,3,3,0,3,3,0,0,0,0,0,3,0,0,0,0,0,0
"kaggle:titanic","rel",57,25,20,8,17,11,4,4,0,6,15,1,6,2,4,0,2,0
"kaggle:titanic","logical",1,1,1,0,1,1,0,0,0,0,0,1,1,0,1,0,0,0
"kaggle:titanic","mode",17,14,12,3,11,5,0,3,1,6,8,0,5,1,4,0,1,1
"kaggle:titanic",".deparseOpts",83,30,20,11,19,8,9,2,0,11,15,2,4,1,3,1,0,0
"kaggle:titanic","deparse",11,11,6,2,9,4,1,1,0,5,8,0,2,1,1,0,1,0
"kaggle:titanic","%in%",4,4,2,1,3,1,1,0,0,2,2,1,4,1,3,1,0,0
"kaggle:titanic","recursive_merge",12,9,2,0,9,2,0,0,0,7,6,1,3,0,3,0,0,0
"kaggle:titanic","get",6,6,4,1,5,3,0,1,0,2,2,2,4,1,3,0,1,0
"kaggle:titanic","assign_func_envs",4,3,2,0,3,2,0,0,0,1,0,2,1,0,1,0,0,0
"kaggle:titanic","list2env2",21,8,6,1,7,4,1,0,0,3,7,0,0,0,0,0,0,0
"kaggle:titanic","lockBinding",8,7,7,1,6,5,0,1,0,1,4,2,0,0,0,0,0,0
"kaggle:titanic","FUN",1,0,0,0,0,0,0,0,0,0,0,0,0,0,0,0,0,0
"kaggle:titanic","toupper",7,3,3,0,3,3,0,0,0,0,2,1,0,0,0,0,0,0
"kaggle:titanic","valid.just",8,4,3,1,3,2,0,1,0,1,1,2,0,0,0,0,0,0
"kaggle:titanic","valid.charjust",92,31,26,5,26,12,5,0,0,14,25,0,0,0,0,0,0,0
"kaggle:titanic","unit",52,24,22,8,16,12,5,3,0,4,9,4,7,2,5,1,1,0
"kaggle:titanic","check_object",17,3,2,1,2,0,1,0,0,2,0,0,1,0,1,0,0,0
"kaggle:titanic","make_proto_method",33,23,14,4,19,8,3,1,0,11,9,6,5,1,4,1,0,0
"kaggle:titanic","",0,0,0,0,0,0,0,0,0,0,0,0,0,0,0,0,0,0
"kaggle:titanic","get_superclassnames",18,8,4,2,6,2,0,2,0,4,4,1,1,0,1,0,0,0
"kaggle:titanic","match.fun",40,15,12,3,12,8,2,1,0,4,10,2,4,0,4,0,0,0
"kaggle:titanic","get",6,6,4,1,5,3,0,1,0,2,2,2,4,1,3,0,1,0
"kaggle:titanic","sys.frame",1,1,1,1,0,0,0,1,0,0,0,0,1,1,0,0,1,0
"kaggle:titanic","get_inherit",3,3,2,0,3,2,0,0,0,1,0,2,0,0,0,0,0,0
"kaggle:titanic","intersect",15,11,8,1,10,4,0,1,0,6,7,1,1,0,1,0,0,0
"kaggle:titanic","nrow",4,3,3,1,2,2,1,0,0,0,0,2,1,0,1,0,0,0
"kaggle:titanic","%||%",3,3,3,1,2,1,1,0,0,1,2,0,3,1,2,1,0,0
"kaggle:titanic","inject",10,5,4,0,5,4,0,0,0,1,2,3,0,0,0,0,0,0
"kaggle:titanic","sort",8,5,3,0,5,0,0,0,0,5,4,0,0,0,0,0,0,0
"kaggle:titanic",".doSortWrap",40,22,21,10,12,9,7,3,0,3,11,0,2,1,1,0,1,0
"kaggle:titanic",".makeSortEnum",13,5,4,3,2,2,3,0,0,0,2,0,0,0,0,0,0,0
"kaggle:titanic","ncol",4,3,3,1,2,2,1,0,0,0,0,2,1,0,1,0,0,0
"kaggle:titanic","is_call",11,6,6,1,5,5,1,0,0,0,2,3,1,0,1,0,0,0
"kaggle:titanic","get_expr",8,5,4,0,5,4,0,0,0,1,3,2,4,0,4,0,0,0
"kaggle:titanic","is_symbol",10,6,6,0,6,4,0,0,0,2,2,2,2,0,2,0,0,0
"kaggle:titanic","is.waive",5,5,4,1,4,1,1,0,0,3,0,1,1,0,1,0,0,0
"kaggle:titanic","unlist",27,5,5,0,5,5,0,0,0,0,5,0,2,0,2,0,0,0
"kaggle:titanic","empty",22,20,16,6,14,8,6,0,0,6,6,5,3,0,3,0,0,0
"kaggle:titanic","FUN",19,14,12,5,9,4,4,1,0,5,4,2,6,1,5,0,1,0
"kaggle:titanic","Sys.getenv",59,19,17,6,13,5,4,2,0,8,11,0,1,0,1,0,0,0
"kaggle:titanic","",35,2,1,0,2,1,0,0,0,1,2,0,0,0,0,0,0,0
"kaggle:titanic","get",6,6,4,1,5,3,0,1,0,2,2,2,4,1,3,0,1,0
"kaggle:titanic","create_formatter",90,52,38,19,33,11,17,2,0,22,31,1,15,1,14,1,0,0
"kaggle:titanic","match",4,4,4,0,4,4,0,0,0,0,0,4,2,0,2,0,0,0
"kaggle:titanic","get",6,6,4,1,5,3,0,1,0,2,2,2,4,1,3,0,1,0
"kaggle:titanic","create_ansi_style",94,60,32,9,51,21,4,5,0,30,43,4,12,2,10,0,2,0
"kaggle:titanic","is_builtin_style",20,17,12,5,12,3,4,1,0,9,9,1,4,1,3,1,0,0
"kaggle:titanic","stop_if_not",18,3,3,1,2,1,1,0,0,1,2,0,0,0,0,0,0,0
"kaggle:titanic","make_ansi_style",121,81,40,16,65,15,6,10,0,50,56,2,12,0,12,0,0,0
"kaggle:titanic","is_r_color",23,18,11,8,10,3,5,3,0,7,7,1,4,1,3,1,0,0
"kaggle:titanic","ansi_style_8_from_rgb",38,28,15,4,24,10,2,2,0,14,17,2,1,0,1,0,0,0
"kaggle:titanic","ansi256",109,38,34,14,24,19,8,6,0,5,19,2,0,0,0,0,0,0
"kaggle:titanic","create_formatter",90,61,45,20,41,17,17,3,0,24,38,2,19,1,18,1,0,0
"kaggle:titanic","sink.number",5,5,3,2,3,0,1,1,0,3,3,0,0,0,0,0,0,0
"kaggle:titanic","isatty",6,6,5,1,5,2,1,0,0,3,2,1,1,0,1,0,0,0
"kaggle:titanic","sink.number",5,5,3,2,3,0,1,1,0,3,3,0,0,0,0,0,0,0
"kaggle:titanic","get_real_output",120,51,32,17,34,15,11,6,0,19,19,8,6,1,5,1,0,0
"kaggle:titanic","is_interactive",45,37,30,10,27,8,8,2,0,19,22,3,5,0,5,0,0,0
"kaggle:titanic","get_real_output",120,51,32,17,34,15,11,6,0,19,19,8,6,1,5,1,0,0
"kaggle:titanic","num_ansi_colors",253,117,88,40,77,30,25,15,0,47,62,9,8,1,7,1,0,0
"kaggle:titanic","no_sink",9,9,6,4,5,2,3,1,0,3,5,0,0,0,0,0,0,0
"kaggle:titanic","get_default_number_of_colors",10,7,5,0,7,3,0,0,0,4,5,2,0,0,0,0,0,0
"kaggle:titanic","os_type",3,2,1,0,2,1,0,0,0,1,0,1,0,0,0,0,0,0
"kaggle:titanic","substr",13,7,7,4,3,3,1,3,0,0,1,2,5,3,2,0,3,0
"kaggle:titanic","unknown--fromConstant",17,11,8,3,8,5,1,2,0,3,5,2,5,2,3,0,2,0
"kaggle:titanic","FUN",19,13,10,4,9,1,1,3,0,8,7,1,4,1,3,0,1,0
"kaggle:titanic","get",6,6,4,1,5,3,0,1,0,2,2,2,4,1,3,0,1,0
"kaggle:titanic","FUN",5,5,1,0,5,1,0,0,0,4,4,0,0,0,0,0,0,0
"kaggle:titanic","grepl",56,16,14,3,13,9,2,1,0,4,9,1,2,0,2,0,0,0
"kaggle:titanic","FUN",133,65,42,16,49,18,6,10,0,31,39,4,16,4,12,0,4,0
"kaggle:titanic","FUN",133,65,42,13,52,21,3,10,0,31,41,5,33,7,26,1,6,0
"kaggle:titanic",".deparseOpts",83,30,27,12,18,11,9,3,0,7,14,2,4,1,3,1,0,0
"kaggle:titanic","deparse",11,11,6,2,9,4,1,1,0,5,8,0,2,1,1,0,1,0
"kaggle:titanic","rep_len",2,2,2,2,0,0,0,2,0,0,0,0,2,2,0,0,2,0
"kaggle:titanic",".row_names_info",2,2,2,0,2,1,0,0,0,1,0,1,0,0,0,0,0,0
"kaggle:titanic","setdiff",22,18,15,2,16,12,1,1,0,4,13,2,11,2,9,1,1,0
"kaggle:titanic","match_selector_node",81,38,20,12,26,8,8,4,0,18,25,1,7,2,5,1,1,0
"kaggle:titanic","match_selector",69,25,19,8,17,6,6,2,0,11,17,0,0,0,0,0,0,0
"kaggle:titanic","%||%",3,3,3,1,2,1,1,0,0,1,0,1,3,1,2,1,0,0
"kaggle:titanic","modifyList",153,61,39,21,40,16,4,17,0,24,39,1,24,6,18,2,4,0
"kaggle:titanic","%||%",3,3,3,1,2,1,1,0,0,1,1,1,3,1,2,1,0,0
"kaggle:titanic","match_selector",69,42,30,13,29,10,11,2,0,19,29,0,4,2,2,0,2,0
"kaggle:titanic","is_flag",10,7,6,1,6,1,1,0,0,5,5,0,0,0,0,0,0,0
"kaggle:titanic","FUN",11,7,7,3,4,2,3,0,0,2,2,1,3,0,3,0,0,0
"kaggle:titanic","%||%",3,3,3,0,3,2,0,0,0,1,2,1,3,0,3,0,0,0
"kaggle:titanic","new_uuid",10,9,4,1,8,3,1,0,0,5,2,2,1,0,1,0,0,0
"kaggle:titanic","modifyList",153,61,39,21,40,16,4,17,0,24,39,1,24,6,18,2,4,0
"kaggle:titanic","%||%",3,3,3,1,2,1,1,0,0,1,1,1,3,1,2,1,0,0
"kaggle:titanic","FUN",13,12,9,1,11,2,1,0,0,9,10,0,2,0,2,0,0,0
"kaggle:titanic","",57,7,4,2,5,2,2,0,0,3,0,2,0,0,0,0,0,0
"kaggle:titanic","Encoding",1,1,1,0,1,1,0,0,0,0,0,1,0,0,0,0,0,0
"kaggle:titanic","rstudio_detect",95,31,18,11,20,9,6,5,0,11,12,5,1,0,1,0,0,0
"kaggle:titanic","%||%",4,4,4,2,2,1,1,1,0,1,1,1,3,2,1,1,1,0
"kaggle:titanic","is_environment",4,4,4,1,3,2,0,1,0,1,0,2,1,0,1,0,0,0
"kaggle:titanic","is_named",20,12,11,2,10,5,2,0,0,5,7,1,10,1,9,1,0,0
"kaggle:titanic","",10,10,9,1,9,1,1,0,0,8,8,0,3,0,3,0,0,0
"kaggle:titanic","conditionCall",1,0,0,0,0,0,0,0,0,0,0,0,0,0,0,0,0,0
"kaggle:titanic","vec_slice",10,5,5,0,5,4,0,0,0,1,2,3,2,0,2,0,0,0
"kaggle:titanic","levels",1,0,0,0,0,0,0,0,0,0,0,0,0,0,0,0,0,0
"kaggle:titanic","flip_data",28,17,15,1,16,2,1,0,0,14,12,1,4,0,4,0,0,0
"kaggle:titanic","aperm",1,0,0,0,0,0,0,0,0,0,0,0,0,0,0,0,0,0
"kaggle:titanic","unique0",4,3,2,0,3,2,0,0,0,1,3,0,3,0,3,0,0,0
"kaggle:titanic","vec_slice",10,5,5,0,5,4,0,0,0,1,2,3,2,0,2,0,0,0
"kaggle:titanic","vec_unique",4,4,1,0,4,1,0,0,0,3,3,0,3,0,3,0,0,0
"kaggle:titanic","vec_unique_loc",5,3,3,0,3,3,0,0,0,0,0,3,1,0,1,0,0,0
"kaggle:titanic","get",6,6,4,1,5,3,0,1,0,2,2,2,4,1,3,0,1,0
"kaggle:titanic","unknown--fromConstant",12,6,6,0,6,6,0,0,0,0,2,4,1,0,1,0,0,0
"kaggle:titanic","apply_fun",65,25,16,5,20,9,5,0,0,11,16,3,4,1,3,1,0,0
"kaggle:titanic","FUN",5,3,3,1,2,2,1,0,0,0,0,2,1,0,1,0,0,0
"kaggle:titanic","setNames",4,3,3,1,2,2,0,1,0,0,1,1,0,0,0,0,0,0
"kaggle:titanic","FUN",6,4,4,0,4,4,0,0,0,0,0,4,2,0,2,0,0,0
"kaggle:titanic","inherits",3,3,3,0,3,2,0,0,0,1,0,2,1,0,1,0,0,0
"kaggle:titanic","FUN",15,9,4,2,7,2,2,0,0,5,4,2,6,1,5,1,0,0
"kaggle:titanic","withCallingHandlers",16,13,13,6,7,4,2,4,0,3,5,2,1,0,1,0,0,0
"kaggle:titanic","suppressWarnings",2,2,1,0,2,1,0,0,0,1,2,0,2,0,2,0,0,0
"kaggle:titanic","get_transformation",3,2,1,0,2,1,0,0,0,1,0,1,1,0,1,0,0,0
"kaggle:titanic","is.logint",9,6,5,0,6,1,0,0,0,5,3,1,1,0,1,0,0,0
"kaggle:titanic","unknown--fromOverride",489,83,81,34,49,36,22,12,0,13,45,0,25,12,13,1,11,0
"kaggle:titanic","",10,8,5,2,6,3,1,1,0,3,6,0,0,0,0,0,0,0
"kaggle:titanic","unknown--fromConstant",1,1,1,0,1,0,0,0,0,1,0,0,0,0,0,0,0,0
"kaggle:titanic","diff",1,0,0,0,0,0,0,0,0,0,0,0,0,0,0,0,0,0
"kaggle:titanic","is.waive",5,5,4,1,4,1,1,0,0,3,0,1,2,0,2,0,0,0
"kaggle:titanic",".coverage.max",21,21,21,1,20,13,1,0,0,7,19,1,0,0,0,0,0,0
"kaggle:titanic",".density.max",9,9,9,0,9,7,0,0,0,2,8,1,0,0,0,0,0,0
"kaggle:titanic","unknown--fromOverride",489,138,129,55,83,58,40,15,0,25,78,1,25,12,13,1,11,0
"kaggle:titanic","",10,8,5,2,6,3,1,1,0,3,6,0,0,0,0,0,0,0
"kaggle:titanic","waiver",57,28,23,8,20,14,4,4,0,6,17,2,6,2,4,0,2,0
"kaggle:titanic","censor",32,20,20,9,11,10,6,3,0,1,9,1,3,2,1,0,2,0
"kaggle:titanic","ifelse",105,56,54,24,32,21,14,10,0,11,27,3,23,13,10,6,7,0
"kaggle:titanic","is_empty",29,9,5,2,7,3,1,1,0,4,6,1,0,0,0,0,0,0
"kaggle:titanic","get",6,6,4,1,5,3,0,1,0,2,2,2,4,1,3,0,1,0
"kaggle:titanic","FUN",39,23,17,6,17,10,5,1,0,7,13,4,0,0,0,0,0,0
"kaggle:titanic","FUN",21,13,5,2,11,3,1,1,0,8,7,2,0,0,0,0,0,0
"kaggle:titanic","grep",95,19,17,2,17,13,2,0,0,4,13,1,2,0,2,0,0,0
"kaggle:titanic","zero_range",60,37,34,10,27,16,9,1,0,11,25,1,0,0,0,0,0,0
"kaggle:titanic","%||%",3,3,3,0,3,2,0,0,0,1,3,0,3,0,3,0,0,0
"kaggle:titanic","%|W|%",9,9,7,2,7,3,2,0,0,4,2,1,5,0,5,0,0,0
"kaggle:titanic","unname",12,6,6,0,6,6,0,0,0,0,3,3,5,0,5,0,0,0
"kaggle:titanic","inherits",3,3,3,0,3,2,0,0,0,1,0,2,1,0,1,0,0,0
"kaggle:titanic","formals",10,5,3,0,5,2,0,0,0,3,2,1,2,0,2,0,0,0
"kaggle:titanic","is_quosure",5,5,4,1,4,1,1,0,0,3,0,1,2,0,2,0,0,0
"kaggle:titanic","tryCatchOne",33,10,4,1,9,3,0,1,0,6,4,2,1,0,1,0,0,0
"kaggle:titanic","FUN",14,14,13,6,8,6,6,0,0,2,7,0,1,0,1,0,0,0
"kaggle:titanic","lapply",17,16,10,0,16,9,0,0,0,7,11,3,10,0,10,0,0,0
"kaggle:titanic","get",6,6,4,1,5,3,0,1,0,2,2,2,4,1,3,0,1,0
"kaggle:titanic","unknown--fromConstant",12,7,6,0,7,6,0,0,0,1,4,3,2,0,2,0,0,0
"kaggle:titanic","FUN",17,15,5,0,15,5,0,0,0,10,8,2,0,0,0,0,0,0
"kaggle:titanic","",107,45,34,9,36,16,5,4,0,20,27,6,3,0,3,0,0,0
"kaggle:titanic","numnotnull",27,17,13,10,7,3,2,8,0,4,4,2,2,0,2,0,0,0
"kaggle:titanic","check.length",13,5,5,4,1,1,1,3,0,0,0,1,1,1,0,0,1,0
"kaggle:titanic","inherits",3,3,3,0,3,3,0,0,0,0,0,3,2,0,2,0,0,0
"kaggle:titanic","isTRUE",11,8,3,3,5,2,3,0,0,3,3,1,1,0,1,0,0,0
"kaggle:titanic","get",6,6,4,1,5,3,0,1,0,2,2,2,4,1,3,0,1,0
"kaggle:titanic","calc_element",99,51,25,6,45,16,5,1,0,29,40,2,9,1,8,0,1,0
"kaggle:titanic","get_element_tree",3,2,1,0,2,1,0,0,0,1,0,1,0,0,0,0,0,0
"kaggle:titanic","get",6,6,4,1,5,3,0,1,0,2,2,2,4,1,3,0,1,0
"kaggle:titanic","Reduce",185,25,23,6,19,14,6,0,0,5,16,1,2,0,2,0,0,0
"kaggle:titanic","f",105,41,25,12,29,11,10,2,0,18,21,2,5,0,5,0,0,0
"kaggle:titanic","is.grob",5,5,4,1,4,1,1,0,0,3,0,1,2,0,2,0,0,0
"kaggle:titanic","isFALSE",11,8,7,4,4,2,4,0,0,2,2,1,1,0,1,0,0,0
"kaggle:titanic","FUN",10,7,5,2,5,1,2,0,0,4,0,1,2,0,2,0,0,0
"kaggle:titanic","simplify2array",151,26,23,8,18,10,5,3,0,8,17,1,10,3,7,0,3,0
"kaggle:titanic","FUN",3,2,1,0,2,1,0,0,0,1,0,1,0,0,0,0,0,0
"kaggle:titanic","character",1,1,1,0,1,1,0,0,0,0,0,1,1,0,1,0,0,0
"kaggle:titanic","get",6,6,4,1,5,3,0,1,0,2,2,2,4,1,3,0,1,0
"kaggle:titanic","is.subclass",46,35,25,7,28,14,4,3,0,14,22,4,13,3,10,1,2,0
"kaggle:titanic","is.rel",5,5,4,1,4,1,1,0,0,3,0,1,3,0,3,0,0,0
"kaggle:titanic","f",105,41,25,12,29,11,10,2,0,18,23,2,7,0,7,0,0,0
"kaggle:titanic","is_theme_element",18,14,10,3,11,3,3,0,0,8,7,1,5,0,5,0,0,0
"kaggle:titanic","unit",52,24,22,8,16,12,5,3,0,4,9,4,8,2,6,1,1,0
"kaggle:titanic","is.unsorted",21,9,9,5,4,4,4,1,0,0,4,0,0,0,0,0,0,0
"kaggle:titanic","modify_list",16,13,13,10,3,3,0,10,0,0,2,1,4,2,2,0,2,0
"kaggle:titanic","is.simpleUnit",5,5,4,1,4,1,1,0,0,3,0,1,3,0,3,0,0,0
"kaggle:titanic","FUN",5,3,3,0,3,3,0,0,0,0,2,1,1,0,1,0,0,0
"kaggle:titanic","%||%",3,3,3,0,3,2,0,0,0,1,3,0,3,0,3,0,0,0
"kaggle:titanic","get",6,6,4,1,5,3,0,1,0,2,2,2,4,1,3,0,1,0
"kaggle:titanic","sapply",32,25,20,7,18,10,4,3,0,8,13,3,9,0,9,0,0,0
"kaggle:titanic","setPackageSlot",6,6,6,2,4,2,0,2,0,2,2,1,1,0,1,0,0,0
"kaggle:titanic","try",4,2,1,0,2,1,0,0,0,1,2,0,2,0,2,0,0,0
"kaggle:titanic","unlist",27,5,5,1,4,4,0,1,0,0,4,0,2,1,1,0,1,0
"kaggle:titanic","validGP",243,81,42,18,63,22,18,0,0,41,50,5,38,1,37,1,0,0
"kaggle:titanic","arg_match0",12,5,5,0,5,5,0,0,0,0,2,3,1,0,1,0,0,0
"kaggle:titanic","get",6,6,4,1,5,3,0,1,0,2,2,2,4,1,3,0,1,0
"kaggle:titanic","calc_element",99,51,25,5,46,16,4,1,0,30,39,3,13,1,12,0,1,0
"kaggle:titanic","get",6,6,4,1,5,3,0,1,0,2,2,2,4,1,3,0,1,0
"kaggle:titanic","Reduce",185,31,25,5,26,18,5,0,0,8,23,1,8,1,7,1,0,0
"kaggle:titanic","f",103,47,31,14,33,15,12,2,0,18,26,2,8,0,8,0,0,0
"kaggle:titanic","get",6,6,4,1,5,3,0,1,0,2,2,2,4,1,3,0,1,0
"kaggle:titanic","calc_element",99,51,25,6,45,16,5,1,0,29,38,3,13,1,12,0,1,0
"kaggle:titanic","upgradeUnit",9,8,6,2,6,2,2,0,0,4,2,1,5,0,5,0,0,0
"kaggle:titanic","as.vector",2,2,2,0,2,1,0,0,0,1,0,1,1,0,1,0,0,0
"kaggle:titanic","FUN",5,3,3,0,3,3,0,0,0,0,2,1,1,0,1,0,0,0
"kaggle:titanic","is.newUnit",5,5,4,1,4,1,1,0,0,3,0,1,3,0,3,0,0,0
"kaggle:titanic","numeric",1,1,1,0,1,1,0,0,0,0,0,1,1,0,1,0,0,0
"kaggle:titanic","unit",54,34,30,11,23,17,8,3,0,6,16,3,9,2,7,1,1,0
"kaggle:titanic","dontCheck",1,1,1,0,1,1,0,0,0,0,0,1,0,0,0,0,0,0
"kaggle:titanic","grid.Call",5,4,2,0,4,2,0,0,0,2,3,1,1,0,1,0,0,0
"kaggle:titanic","identicalUnits",5,3,3,0,3,3,0,0,0,0,0,3,2,0,2,0,0,0
"kaggle:titanic","valid.just",8,7,4,1,6,3,0,1,0,3,4,1,1,1,0,0,1,0
"kaggle:titanic","valid.numjust",13,7,7,2,5,2,2,0,0,3,5,0,0,0,0,0,0,0
"kaggle:titanic","numeric",1,1,1,0,1,0,0,0,0,1,0,0,1,0,1,0,0,0
"kaggle:titanic","is.grob",5,5,2,1,4,1,1,0,0,3,0,1,2,0,2,0,0,0
"kaggle:titanic","check.length",13,5,5,4,1,1,1,3,0,0,0,1,1,1,0,0,1,0
"kaggle:titanic","get",6,6,4,1,5,3,0,1,0,2,2,2,4,1,3,0,1,0
"kaggle:titanic","sapply",32,25,20,7,18,10,4,3,0,8,13,3,9,0,9,0,0,0
"kaggle:titanic","setChildren",51,22,15,3,19,10,3,0,0,9,11,3,5,0,5,0,0,0
"kaggle:titanic","isTRUE",11,8,8,4,4,3,4,0,0,1,3,1,2,1,1,1,0,0
"kaggle:titanic","ggname",7,1,1,0,1,1,0,0,0,0,0,1,0,0,0,0,0,0
"kaggle:titanic","neg_to_pos",8,8,1,1,7,0,1,0,0,7,5,0,0,0,0,0,0,0
"kaggle:titanic","new_data_frame",22,16,16,8,8,7,5,3,0,1,4,3,3,1,2,0,1,0
"kaggle:titanic","ifelse",105,56,54,24,32,21,14,10,0,11,27,3,23,13,10,6,7,0
"kaggle:titanic","check_gtable",20,8,6,2,6,1,2,0,0,5,0,1,2,0,2,0,0,0
"kaggle:titanic","zeroGrob",1,1,1,0,1,1,0,0,0,0,0,1,0,0,0,0,0,0
"kaggle:titanic","check_number_whole",22,9,3,1,8,1,1,0,0,7,6,0,0,0,0,0,0,0
"kaggle:titanic","is_list",7,4,4,1,3,3,1,0,0,0,0,3,1,0,1,0,0,0
"kaggle:titanic","neg_to_pos",8,8,1,1,7,0,1,0,0,7,5,0,0,0,0,0,0,0
"kaggle:titanic","single_unit",20,7,7,0,7,7,0,0,0,0,0,7,0,0,0,0,0,0
"kaggle:titanic","is.gpar",5,5,4,1,4,1,1,0,0,3,0,1,2,0,2,0,0,0
"kaggle:titanic","is.pattern",5,5,4,1,4,1,1,0,0,3,0,1,3,0,3,0,0,0
"kaggle:titanic","valid.charjust",92,33,28,5,28,14,5,0,0,14,27,0,0,0,0,0,0,0
"kaggle:titanic","vpObject",50,28,24,0,28,24,0,0,0,4,21,6,8,0,8,0,0,0
"kaggle:titanic","valid.viewport",152,111,84,33,78,42,27,6,0,36,67,4,16,0,16,0,0,0
"kaggle:titanic","diff",1,0,0,0,0,0,0,0,0,0,0,0,0,0,0,0,0,0
"kaggle:titanic","get",6,6,4,1,5,3,0,1,0,2,2,2,4,1,3,0,1,0
"kaggle:titanic","setChildren",51,22,15,3,19,10,3,0,0,9,11,3,5,0,5,0,0,0
"kaggle:titanic","set.gpar",133,59,29,13,46,14,13,0,0,32,38,4,15,1,14,1,0,0
"kaggle:titanic","preDraw",1,0,0,0,0,0,0,0,0,0,0,0,0,0,0,0,0,0
"kaggle:titanic","makeContent",1,0,0,0,0,0,0,0,0,0,0,0,0,0,0,0,0,0
"kaggle:titanic","drawDetails",1,0,0,0,0,0,0,0,0,0,0,0,0,0,0,0,0,0
"kaggle:titanic","grid.draw",2,1,1,0,1,1,0,0,0,0,0,1,0,0,0,0,0,0
"kaggle:titanic","postDraw",1,0,0,0,0,0,0,0,0,0,0,0,0,0,0,0,0,0
"kaggle:titanic","match",4,4,4,0,4,4,0,0,0,0,0,4,3,0,3,0,0,0
"kaggle:titanic","strsplit",7,6,3,1,5,2,0,1,0,3,4,1,1,0,1,0,0,0
"kaggle:titanic","rootVP",4,3,1,1,2,0,1,0,0,2,0,0,0,0,0,0,0,0
"kaggle:titanic","vpPathFromVector",88,35,25,6,29,13,3,3,0,16,23,3,4,1,3,0,1,0
"kaggle:titanic","postDraw",1,0,0,0,0,0,0,0,0,0,0,0,0,0,0,0,0,0
"kaggle:titanic","preDraw",1,0,0,0,0,0,0,0,0,0,0,0,0,0,0,0,0,0
"kaggle:titanic","drawGTree",41,27,9,1,26,8,1,0,0,18,23,3,4,0,4,0,0,0
"kaggle:titanic","NextMethod",4,1,1,0,1,1,0,0,0,0,0,1,1,0,1,0,0,0
"kaggle:titanic","set.gpar",133,59,29,13,46,14,13,0,0,32,38,4,15,1,14,1,0,0
"kaggle:titanic","unique.default",52,6,6,0,6,1,0,0,0,5,6,0,2,0,2,0,0,0
"kaggle:titanic","current.vpPath",44,29,16,7,22,9,3,4,0,13,19,1,2,1,1,0,1,0
"kaggle:titanic","vpPathFromVector",88,35,25,7,28,12,3,4,0,16,21,3,6,1,5,0,1,0
"kaggle:titanic","strsplit",7,6,3,2,4,1,0,2,0,3,4,0,1,1,0,0,1,0
"kaggle:titanic","formals",10,5,3,0,5,3,0,0,0,2,2,1,2,0,2,0,0,0
"kaggle:titanic","is.ordered",5,5,4,1,4,1,1,0,0,3,0,1,3,0,3,0,0,0
"kaggle:titanic","FUN",11,10,7,3,7,2,0,3,0,5,6,0,1,0,1,0,0,0
"kaggle:titanic","FUN",6,5,5,1,4,4,0,1,0,0,2,2,0,0,0,0,0,0
"kaggle:titanic","lockEnvironment",2,2,2,0,2,1,0,0,0,1,0,1,1,0,1,0,0,0
"kaggle:titanic","eval_bare",8,4,4,0,4,4,0,0,0,0,0,4,1,0,1,0,0,0
"kaggle:titanic","FUN",5,2,2,0,2,2,0,0,0,0,0,2,0,0,0,0,0,0
"kaggle:titanic","is_formula",9,5,5,1,4,4,1,0,0,0,0,4,2,0,2,0,0,0
"kaggle:titanic","new.env",4,4,3,3,1,0,1,2,0,1,0,0,2,2,0,0,2,0
"kaggle:titanic","ggproto",65,25,18,6,19,9,4,2,0,10,14,2,8,3,5,1,2,0
"kaggle:titanic","quo_get_expr",5,3,3,0,3,3,0,0,0,0,0,3,1,0,1,0,0,0
"kaggle:titanic","is_string",7,4,4,1,3,3,1,0,0,0,0,3,2,0,2,0,0,0
"kaggle:titanic","get_expr",8,5,4,0,5,4,0,0,0,1,3,2,4,0,4,0,0,0
"kaggle:titanic","get",6,6,4,1,5,3,0,1,0,2,2,2,4,1,3,0,1,0
"kaggle:titanic","unknown--fromConstant",45,18,16,4,14,10,2,2,0,4,10,1,6,0,6,0,0,0
"kaggle:titanic","strip_dots",106,55,34,10,45,21,5,5,0,24,33,5,12,1,11,0,1,0
"kaggle:titanic","ggproto_formals",5,4,1,0,4,1,0,0,0,3,0,1,0,0,0,0,0,0
"kaggle:titanic","as.vector",2,2,2,0,2,2,0,0,0,0,0,2,1,0,1,0,0,0
"kaggle:titanic","names2",7,4,4,0,4,4,0,0,0,0,2,2,1,0,1,0,0,0
"kaggle:titanic","new_quosure",8,4,4,0,4,4,0,0,0,0,0,4,1,0,1,0,0,0
"kaggle:titanic","inject",10,5,4,0,5,3,0,0,0,2,2,2,1,0,1,0,0,0
"kaggle:titanic","every",95,32,21,5,27,16,5,0,0,11,23,3,9,0,9,0,0,0
"kaggle:titanic","is_symbolic",8,8,3,2,6,1,2,0,0,5,2,1,5,1,4,1,0,0
"kaggle:titanic","union",6,6,4,0,6,4,0,0,0,2,6,0,0,0,0,0,0,0
"kaggle:titanic","caller_env",3,3,1,0,3,1,0,0,0,2,2,1,0,0,0,0,0,0
"kaggle:titanic","allow_lambda",14,8,7,2,6,5,2,0,0,1,2,4,4,0,4,0,0,0
"kaggle:titanic","element_line",87,54,37,11,43,18,7,4,0,25,35,3,13,2,11,0,2,0
"kaggle:titanic","is_theme_element",18,16,11,4,12,3,4,0,0,9,8,1,5,0,5,0,0,0
"kaggle:titanic","is_theme",5,5,4,1,4,1,1,0,0,3,0,1,2,0,2,0,0,0
"kaggle:titanic","element_rect",85,52,36,11,41,17,7,4,0,24,32,4,13,2,11,0,2,0
"kaggle:titanic","",8,4,4,2,2,1,0,2,0,1,2,0,0,0,0,0,0,0
"kaggle:titanic","new.env",4,4,3,3,1,0,1,2,0,1,0,0,2,2,0,0,2,0
"kaggle:titanic","get",6,6,4,1,5,3,0,1,0,2,2,2,4,1,3,0,1,0
"kaggle:titanic","create_super_env",130,51,31,7,44,21,1,6,0,23,40,3,1,0,1,0,0,0
"kaggle:titanic","get0",6,6,5,1,5,4,0,1,0,1,0,4,3,1,2,0,1,0
"kaggle:titanic","getHook",4,4,1,0,4,1,0,0,0,3,2,0,0,0,0,0,0,0
"kaggle:titanic","new.env",4,4,3,3,1,0,1,2,0,1,0,0,2,2,0,0,2,0
"kaggle:titanic","eval",8,7,3,1,6,2,0,0,1,4,5,1,2,1,1,0,0,1
"kaggle:titanic","get",6,6,4,1,5,3,0,1,0,2,2,2,4,1,3,0,1,0
"kaggle:titanic","lockEnvironment",2,2,2,1,1,1,0,1,0,0,0,1,1,1,0,0,1,0
"kaggle:titanic","",306,127,78,33,94,34,17,16,0,60,85,5,6,0,6,0,0,0
"kaggle:titanic","create_super_env",130,51,31,7,44,21,1,6,0,23,40,3,1,0,1,0,0,0
"kaggle:titanic","lockBinding",8,7,7,1,6,5,0,1,0,1,3,3,0,0,0,0,0,0
"kaggle:titanic","lockBinding",8,7,7,1,6,4,0,1,0,2,3,2,0,0,0,0,0,0
"kaggle:titanic","by_layer",36,23,7,2,21,4,1,1,0,17,16,2,1,0,1,0,0,0
"kaggle:titanic","try_fetch",6,4,4,1,3,2,0,1,0,1,1,1,1,0,1,0,0,0
"kaggle:titanic","defaults",47,30,16,0,30,16,0,0,0,14,28,2,16,0,16,0,0,0
"kaggle:titanic","vec_ptype",11,5,5,0,5,5,0,0,0,0,0,5,0,0,0,0,0,0
"kaggle:titanic","vec_set_names",7,4,4,0,4,4,0,0,0,0,2,2,0,0,0,0,0,0
"kaggle:titanic","is_atomic",7,4,4,1,3,3,1,0,0,0,0,3,1,0,1,0,0,0
"kaggle:titanic","accessor",1,1,1,1,0,0,0,1,0,0,0,0,1,1,0,0,1,0
"kaggle:titanic","accessor",1,1,1,1,0,0,0,1,0,0,0,0,1,1,0,0,1,0
"kaggle:titanic","frame_get",42,35,20,3,32,16,3,0,0,16,26,5,4,0,4,0,0,0
"kaggle:titanic","call2",7,4,4,0,4,4,0,0,0,0,0,4,1,0,1,0,0,0
"kaggle:titanic","sub",45,20,18,5,15,11,2,3,0,4,11,1,5,0,5,0,0,0
"kaggle:titanic","standardise_aes_names",65,29,16,7,22,7,4,3,0,15,17,1,5,1,4,1,0,0
"kaggle:titanic","env_bind0",12,5,5,0,5,4,0,0,0,1,2,3,3,0,3,0,0,0
"kaggle:titanic","get",6,6,4,1,5,3,0,1,0,2,2,2,4,1,3,0,1,0
"kaggle:titanic","warn_for_aes_extract_usage_expr",35,15,11,4,11,7,3,1,0,4,5,4,7,1,6,0,1,0
"kaggle:titanic","has_default_transform",20,18,11,2,16,3,2,0,0,13,13,0,2,0,2,0,0,0
"kaggle:titanic","has_default_transform",20,18,11,2,16,3,2,0,0,13,13,0,2,0,2,0,0,0
"kaggle:titanic","FUN",20,18,13,2,16,5,2,0,0,11,14,1,4,0,4,0,0,0
"kaggle:titanic","recursive_merge",12,9,2,0,9,2,0,0,0,7,6,1,3,0,3,0,0,0
"kaggle:titanic","get",6,6,4,1,5,3,0,1,0,2,2,2,4,1,3,0,1,0
"kaggle:titanic","assign_func_envs",4,3,2,0,3,2,0,0,0,1,0,2,1,0,1,0,0,0
"kaggle:titanic","split_with_index",25,17,12,2,15,10,1,1,0,5,10,4,0,0,0,0,0,0
"kaggle:titanic","is_same_type",40,30,15,3,27,12,3,0,0,15,23,4,14,0,14,0,0,0
"kaggle:titanic","vec_cast",14,5,5,0,5,5,0,0,0,0,3,2,3,0,3,0,0,0
"kaggle:titanic","vec_ptype",11,5,5,0,5,5,0,0,0,0,2,3,2,0,2,0,0,0
"kaggle:titanic","vec_assert",72,42,30,6,36,14,6,0,0,22,31,4,17,0,17,0,0,0
"kaggle:titanic","vec_size",7,4,4,1,3,3,1,0,0,0,0,3,1,0,1,0,0,0
"kaggle:titanic","expr",2,1,1,0,1,1,0,0,0,0,0,1,0,0,0,0,0,0
"kaggle:titanic","double",1,1,1,0,1,0,0,0,0,1,0,0,0,0,0,0,0,0
"kaggle:titanic","get",6,6,4,1,5,3,0,1,0,2,2,2,4,1,3,0,1,0
"kaggle:titanic","scale_apply",50,35,24,7,28,16,6,1,0,12,18,7,4,0,4,0,0,0
"kaggle:titanic","get_limits",54,8,4,1,7,3,1,0,0,4,4,3,0,0,0,0,0,0
"kaggle:titanic","vec_cast",14,7,5,0,7,5,0,0,0,2,4,2,3,0,3,0,0,0
"kaggle:titanic","accessor",1,1,1,1,0,0,0,1,0,0,0,0,1,1,0,0,1,0
"kaggle:titanic","replace",4,4,4,2,2,2,1,1,0,0,2,0,0,0,0,0,0,0
"kaggle:titanic","FUN",8,8,7,2,6,3,1,1,0,3,5,1,0,0,0,0,0,0
"kaggle:titanic","make.unique",2,2,2,1,1,1,0,1,0,0,0,1,0,0,0,0,0,0
"kaggle:titanic","clii__vspace",54,4,3,2,2,1,2,0,0,1,0,1,0,0,0,0,0,0
"kaggle:titanic","get",6,6,4,1,5,3,0,1,0,2,2,2,4,1,3,0,1,0
"kaggle:titanic","make_ansi_style",96,62,32,13,49,10,5,8,0,39,45,1,13,0,13,0,0,0
"kaggle:titanic","ansi256",109,38,34,14,24,19,8,6,0,5,19,2,0,0,0,0,0,0
"kaggle:titanic","ansi_style_from_r_color",25,19,8,4,15,4,1,3,0,11,10,1,1,1,0,0,1,0
"kaggle:titanic","create_formatter",90,61,26,20,41,17,17,3,0,24,38,2,19,1,18,1,0,0
"kaggle:titanic","merge_embedded_styles",112,66,37,16,50,19,12,4,0,31,47,1,28,1,27,0,1,0
"kaggle:titanic","",1,0,0,0,0,0,0,0,0,0,0,0,0,0,0,0,0,0
"kaggle:titanic","last",6,4,4,1,3,3,0,1,0,0,2,1,3,1,2,0,1,0
"kaggle:titanic","%||%",3,3,3,0,3,2,0,0,0,1,3,0,3,0,3,0,0,0
"kaggle:titanic","",8,5,4,1,4,3,0,1,0,1,2,1,0,0,0,0,0,0
"kaggle:titanic","call_if_fun",11,10,6,1,9,4,1,0,0,5,2,3,3,1,2,1,0,0
"kaggle:titanic","substring",38,23,23,11,12,10,4,7,0,2,11,1,8,6,2,0,6,0
"kaggle:titanic","ansi_strip",33,17,11,1,16,10,0,1,0,6,15,1,0,0,0,0,0,0
"kaggle:titanic","rep.int",2,2,2,1,1,1,0,1,0,0,0,1,2,1,1,0,1,0
"kaggle:titanic","vapply",15,9,8,0,9,8,0,0,0,1,6,3,6,0,6,0,0,0
"kaggle:titanic","get",6,6,4,1,5,3,0,1,0,2,2,2,4,1,3,0,1,0
"kaggle:titanic","clii__container_end",308,100,39,12,88,23,10,2,0,65,67,8,9,1,8,1,0,0
"kaggle:titanic","FUN",12,7,5,1,6,1,1,0,0,5,5,0,3,0,3,0,0,0
"kaggle:titanic","is_yes",8,8,3,2,6,1,2,0,0,5,4,1,4,1,3,1,0,0
"kaggle:titanic","vapply",15,9,8,0,9,8,0,0,0,1,6,3,6,0,6,0,0,0
"kaggle:titanic","get",6,6,4,1,5,3,0,1,0,2,2,2,4,1,3,0,1,0
"kaggle:titanic","vlapply",5,5,1,0,5,1,0,0,0,4,2,1,0,0,0,0,0,0
"kaggle:titanic","get",6,6,4,1,5,3,0,1,0,2,2,2,4,1,3,0,1,0
"kaggle:titanic","viapply",5,5,1,0,5,1,0,0,0,4,0,1,0,0,0,0,0,0
"kaggle:titanic","%||%",4,4,4,0,4,3,0,0,0,1,3,1,3,0,3,0,0,0
"kaggle:titanic","is_character",7,4,4,1,3,3,1,0,0,0,0,3,2,0,2,0,0,0
"kaggle:titanic","unknown--fromConstant",5,4,4,0,4,3,0,0,0,1,2,2,0,0,0,0,0,0
"kaggle:titanic","vec_cast",14,7,5,0,7,5,0,0,0,2,4,2,3,0,3,0,0,0
"kaggle:titanic","vec_size",7,4,4,1,3,3,1,0,0,0,0,3,1,0,1,0,0,0
"kaggle:titanic","mapped_discrete",14,9,3,0,9,3,0,0,0,6,7,2,2,0,2,0,0,0
"kaggle:titanic","FUN",6,4,3,0,4,2,0,0,0,2,4,0,2,0,2,0,0,0
"kaggle:titanic","mostattributes<-",106,3,3,1,2,2,1,0,0,0,0,2,1,0,1,0,0,0
"kaggle:titanic","FUN",6,4,3,0,4,2,0,0,0,2,4,0,0,0,0,0,0,0
"kaggle:titanic","diff",1,0,0,0,0,0,0,0,0,0,0,0,0,0,0,0,0,0
"kaggle:titanic","FUN",5,3,3,1,2,2,1,0,0,0,0,2,1,0,1,0,0,0
"kaggle:titanic","FUN",5,3,3,1,2,2,1,0,0,0,0,2,1,0,1,0,0,0
"kaggle:titanic","get_expr",8,5,4,0,5,4,0,0,0,1,3,2,4,0,4,0,0,0
"kaggle:titanic","rep_len",2,2,2,1,1,1,0,1,0,0,0,1,2,1,1,0,1,0
"kaggle:titanic","lengths",2,2,2,0,2,2,0,0,0,0,0,2,1,0,1,0,0,0
"kaggle:titanic","unique",1,0,0,0,0,0,0,0,0,0,0,0,0,0,0,0,0,0
"kaggle:titanic","factor",93,55,45,15,40,27,10,5,0,13,33,4,20,3,17,1,2,0
"kaggle:titanic","FUN",34,26,19,5,21,12,4,1,0,9,13,3,6,0,6,0,0,0
"kaggle:titanic","is.discrete",13,11,9,3,8,4,3,0,0,4,1,3,5,0,5,0,0,0
"kaggle:titanic","get",6,6,4,1,5,3,0,1,0,2,2,2,4,1,3,0,1,0
"kaggle:titanic","FUN",39,25,17,5,20,11,4,1,0,9,15,4,3,0,3,0,0,0
"kaggle:titanic","",11,1,1,0,1,1,0,0,0,0,0,1,0,0,0,0,0,0
"kaggle:titanic","obj_is_vector",5,3,3,1,2,2,1,0,0,0,0,2,1,0,1,0,0,0
"kaggle:titanic","vec_ptype_finalise",6,3,3,0,3,3,0,0,0,0,2,1,2,0,2,0,0,0
"kaggle:titanic",".simplicity",38,29,17,9,20,8,9,0,0,12,19,0,0,0,0,0,0,0
"kaggle:titanic",".coverage",18,18,18,0,18,15,0,0,0,3,18,0,0,0,0,0,0,0
"kaggle:titanic",".density",34,24,24,0,24,18,0,0,0,6,24,0,0,0,0,0,0,0
"kaggle:titanic",".legibility",0,0,0,0,0,0,0,0,0,0,0,0,0,0,0,0,0,0
"kaggle:titanic",".simplicity.max",17,16,14,6,10,7,6,0,0,3,10,0,0,0,0,0,0,0
"kaggle:titanic","FUN",11,7,7,4,3,2,3,1,0,1,3,0,3,1,2,0,1,0
"kaggle:titanic","FUN",10,6,5,0,6,4,0,0,0,2,4,2,3,0,3,0,0,0
"kaggle:titanic","transform_position",54,43,23,10,33,13,3,7,0,20,31,2,8,3,5,1,2,0
"kaggle:titanic","do.call",9,9,6,1,8,5,0,1,0,3,5,2,3,1,2,0,1,0
"kaggle:titanic","get",6,6,4,1,5,3,0,1,0,2,2,2,4,1,3,0,1,0
"kaggle:titanic","as_label",107,59,31,8,51,21,8,0,0,30,35,8,14,0,14,0,0,0
"kaggle:titanic","caller_arg",34,17,10,0,17,7,0,0,0,10,7,3,1,0,1,0,0,0
"kaggle:titanic","duplicate",7,4,4,0,4,4,0,0,0,0,2,2,0,0,0,0,0,0
"kaggle:titanic","arg_match0",12,5,5,0,5,5,0,0,0,0,2,3,1,0,1,0,0,0
"kaggle:titanic","current_env",1,1,1,0,1,1,0,0,0,0,0,1,0,0,0,0,0,0
"kaggle:titanic","check_arg",25,9,9,0,9,4,0,0,0,5,2,2,2,0,2,0,0,0
"kaggle:titanic","aes_to_scale",17,15,7,4,11,3,3,1,0,8,10,1,4,1,3,1,0,0
"kaggle:titanic","%||%",3,3,3,2,1,0,1,1,0,1,0,0,2,1,1,1,0,0
"kaggle:titanic","resolve_guide",24,21,12,2,19,6,2,0,0,13,13,1,13,0,13,0,0,0
"kaggle:titanic","new.env",4,4,3,3,1,0,1,2,0,1,0,0,2,2,0,0,2,0
"kaggle:titanic","get",6,6,4,1,5,3,0,1,0,2,2,2,4,1,3,0,1,0
"kaggle:titanic","exists",8,6,4,1,5,3,0,1,0,2,0,3,4,1,3,0,1,0
"kaggle:titanic","new_guide",154,78,40,6,72,32,2,4,0,40,67,5,16,0,16,0,0,0
"kaggle:titanic","ggproto",65,25,18,6,19,9,4,2,0,10,14,2,8,3,5,1,2,0
"kaggle:titanic","validate_guide",28,17,12,3,14,6,2,1,0,8,8,2,3,0,3,0,0,0
"kaggle:titanic","check_subclass",45,30,17,6,24,9,5,1,0,15,13,5,6,1,5,0,1,0
"kaggle:titanic","vec_cast",14,7,5,0,7,5,0,0,0,2,4,2,3,0,3,0,0,0
"kaggle:titanic","vec_assert",72,42,30,6,36,14,6,0,0,22,31,4,17,0,17,0,0,0
"kaggle:titanic","find_global",17,8,2,1,7,1,1,0,0,6,6,1,1,0,1,0,0,0
"kaggle:titanic","find_global",17,8,2,1,7,1,1,0,0,6,6,1,1,0,1,0,0,0
"kaggle:titanic","get",6,6,4,1,5,3,0,1,0,2,2,2,4,1,3,0,1,0
"kaggle:titanic","compact",8,7,4,1,6,3,1,0,0,3,4,0,0,0,0,0,0,0
"kaggle:titanic","as.matrix",1,0,0,0,0,0,0,0,0,0,0,0,0,0,0,0,0,0
"kaggle:titanic","is_empty",8,3,1,0,3,1,0,0,0,2,2,1,0,0,0,0,0,0
"kaggle:titanic","get",6,6,4,1,5,3,0,1,0,2,2,2,4,1,3,0,1,0
"kaggle:titanic","new_aes",81,36,25,9,27,14,5,4,0,13,22,1,12,2,10,0,2,0
"kaggle:titanic","match",4,4,4,0,4,4,0,0,0,0,2,2,3,0,3,0,0,0
"kaggle:titanic","FUN",10,6,5,0,6,4,0,0,0,2,4,2,3,0,3,0,0,0
"kaggle:titanic","FUN",28,18,10,5,13,3,5,0,0,10,5,2,11,1,10,1,0,0
"kaggle:titanic","aesthetics",60,25,14,2,23,11,0,2,0,12,21,0,2,0,2,0,0,0
"kaggle:titanic","label_ordinal",5,5,1,0,5,1,0,0,0,4,4,1,0,0,0,0,0,0
"kaggle:titanic","vec_cast",14,7,5,0,7,5,0,0,0,2,4,2,3,0,3,0,0,0
"kaggle:titanic","FUN",14,14,13,2,12,10,2,0,0,2,11,0,6,0,6,0,0,0
"kaggle:titanic","get",6,6,4,1,5,3,0,1,0,2,2,2,4,1,3,0,1,0
"kaggle:titanic","caller_arg",34,17,10,0,17,7,0,0,0,10,7,3,1,0,1,0,0,0
"kaggle:titanic","integer",1,1,1,0,1,1,0,0,0,0,0,1,1,0,1,0,0,0
"kaggle:titanic","make.names",20,18,12,4,14,5,1,3,0,9,11,1,0,0,0,0,0,0
"kaggle:titanic","transform_position",54,43,23,10,33,13,3,7,0,20,31,2,8,3,5,1,2,0
"kaggle:titanic","transform",16,12,2,0,12,2,0,0,0,10,12,0,0,0,0,0,0,0
"kaggle:titanic","as.matrix",1,0,0,0,0,0,0,0,0,0,0,0,0,0,0,0,0,0
"kaggle:titanic","",10,10,2,0,10,1,0,0,0,9,5,1,2,0,2,0,0,0
"kaggle:titanic","encode_c",46,33,23,8,25,16,7,1,1,9,19,5,10,2,8,1,1,1
"kaggle:titanic","is_linear",0,0,0,0,0,0,0,0,0,0,0,0,0,0,0,0,0,0
"kaggle:titanic","unit",54,34,30,10,24,18,8,2,0,6,17,3,9,1,8,1,0,0
"kaggle:titanic","ncol",4,3,3,1,2,2,1,0,0,0,0,2,1,0,1,0,0,0
"kaggle:titanic","",107,45,35,10,35,17,6,4,0,18,27,6,4,1,3,1,0,0
"kaggle:titanic","unknown--fromConstant",5,3,3,0,3,3,0,0,0,0,0,3,1,0,1,0,0,0
"kaggle:titanic","encode_c",46,33,23,8,25,16,7,1,1,9,19,5,10,2,8,1,1,1
"kaggle:titanic","alpha",109,40,25,7,33,13,2,5,0,20,26,2,13,3,10,0,3,0
"kaggle:titanic","check_linewidth",17,3,2,0,3,2,0,0,0,1,2,1,1,0,1,0,0,0
"kaggle:titanic","check_bool",16,6,6,1,5,4,1,0,0,1,3,1,0,0,0,0,0,0
"kaggle:titanic","unit",54,34,30,10,24,18,8,2,0,6,17,3,9,1,8,1,0,0
"kaggle:titanic","ggname",7,1,1,0,1,1,0,0,0,0,0,1,0,0,0,0,0,0
"kaggle:titanic","get",6,6,4,1,5,3,0,1,0,2,2,2,4,1,3,0,1,0
"kaggle:titanic","remove_missing",94,69,35,10,59,23,9,1,0,36,43,7,11,0,11,0,0,0
"kaggle:titanic","",8,6,2,0,6,2,0,0,0,4,4,1,0,0,0,0,0,0
"kaggle:titanic","logical",1,1,1,1,0,0,0,1,0,0,0,0,1,1,0,0,1,0
"kaggle:titanic","FUN",20,12,10,2,10,5,2,0,0,5,3,3,4,0,4,0,0,0
"kaggle:titanic","fill_alpha",38,4,2,1,3,1,0,1,0,2,2,0,4,1,3,0,1,0
"kaggle:titanic","rowSums",91,43,40,18,25,17,16,2,0,8,20,2,3,0,3,0,0,0
"kaggle:titanic","alpha",109,40,25,7,33,13,2,5,0,20,26,2,13,3,10,0,3,0
"kaggle:titanic","fill_alpha",38,4,2,1,3,1,0,1,0,2,2,0,4,1,3,0,1,0
"kaggle:titanic","FUN",11,7,7,4,3,3,3,1,0,0,3,0,3,1,2,0,1,0
"kaggle:titanic","character",1,1,1,0,1,1,0,0,0,0,0,1,1,0,1,0,0,0
"kaggle:titanic","get",6,6,4,1,5,3,0,1,0,2,2,2,4,1,3,0,1,0
"kaggle:titanic","detect_missing",47,39,19,5,34,11,5,0,0,23,27,3,8,0,8,0,0,0
"kaggle:titanic","modify_list",16,14,13,7,7,6,0,7,0,1,6,1,6,1,5,0,1,0
"kaggle:titanic","element_grob",1,0,0,0,0,0,0,0,0,0,0,0,0,0,0,0,0,0
"kaggle:titanic","get",6,6,4,1,5,3,0,1,0,2,2,2,4,1,3,0,1,0
"kaggle:titanic","calc_element",99,51,25,5,46,16,4,1,0,30,39,3,13,1,12,0,1,0
"kaggle:titanic","FUN",7,7,2,0,7,2,0,0,0,5,3,1,2,0,2,0,0,0
"kaggle:titanic","len0_null",5,4,4,2,2,1,2,0,0,1,0,1,0,0,0,0,0,0
"kaggle:titanic","vec_recycle",10,5,5,1,4,4,1,0,0,0,1,3,0,0,0,0,0,0
"kaggle:titanic","unit",54,34,30,10,24,18,8,2,0,6,17,3,9,1,8,1,0,0
"kaggle:titanic","unit",54,34,30,10,24,18,8,2,0,6,17,3,9,1,8,1,0,0
"kaggle:titanic","upgradeUnit",9,8,6,2,6,2,2,0,0,4,2,1,5,0,5,0,0,0
"kaggle:titanic","convertUnit",49,46,23,9,37,14,9,0,0,23,34,2,4,0,4,0,0,0
"kaggle:titanic","valid.units",5,3,3,1,2,2,1,0,0,0,0,2,0,0,0,0,0,0
"kaggle:titanic","is_symbol",10,6,6,1,5,4,0,1,0,1,2,2,2,1,1,0,1,0
"kaggle:titanic",".set_row_names",6,5,5,0,5,3,0,0,0,2,2,2,1,0,1,0,0,0
"kaggle:titanic","grobWidth",1,0,0,0,0,0,0,0,0,0,0,0,0,0,0,0,0,0
"kaggle:titanic","check_unit",20,8,6,2,6,1,2,0,0,5,0,1,3,0,3,0,0,0
"kaggle:titanic","get",6,6,4,1,5,3,0,1,0,2,2,2,4,1,3,0,1,0
"kaggle:titanic","sapply",32,25,20,7,18,10,4,3,0,8,13,3,9,0,9,0,0,0
"kaggle:titanic","gList",28,17,10,3,14,5,3,0,0,9,11,3,6,0,6,0,0,0
"kaggle:titanic","gtable_add_cols",117,38,14,5,33,7,5,0,0,26,21,3,6,0,6,0,0,0
"kaggle:titanic","sys.parent",1,1,1,0,1,1,0,0,0,0,0,1,1,0,1,0,0,0
"kaggle:titanic","is_theme_complete",14,11,10,1,10,1,1,0,0,9,6,0,2,0,2,0,0,0
"kaggle:titanic","add_theme",63,51,14,5,46,8,5,0,0,38,41,0,4,0,4,0,0,0
"kaggle:titanic","is_theme_validate",17,13,3,1,12,2,1,0,0,10,8,1,2,0,2,0,0,0
"kaggle:titanic","is_theme_validate",20,16,16,1,15,2,1,0,0,13,11,1,5,0,5,0,0,0
"kaggle:titanic","merge_element",1,0,0,0,0,0,0,0,0,0,0,0,0,0,0,0,0,0
"kaggle:titanic","is.subclass",44,33,21,5,28,14,3,2,0,14,21,5,15,1,14,0,1,0
"kaggle:titanic","xor",17,7,7,5,2,0,5,0,0,2,2,0,0,0,0,0,0,0
"kaggle:titanic","get",6,6,4,1,5,3,0,1,0,2,2,2,4,1,3,0,1,0
"kaggle:titanic","sapply",32,25,20,7,18,10,4,3,0,8,13,3,9,0,9,0,0,0
"kaggle:titanic","textGrob",44,33,12,3,30,7,3,0,0,23,21,3,9,0,9,0,0,0
"kaggle:titanic","unit",54,34,30,10,24,18,8,2,0,6,17,3,9,1,8,1,0,0
"kaggle:titanic","validGrob",1,0,0,0,0,0,0,0,0,0,0,0,0,0,0,0,0,0
"kaggle:titanic","convertUnit",49,46,20,8,38,15,8,0,0,23,34,2,6,1,5,1,0,0
"kaggle:titanic","font_descent",44,37,20,7,30,9,3,4,0,21,21,3,4,0,4,0,0,0
"kaggle:titanic","",11,8,8,4,4,3,3,1,0,1,1,3,0,0,0,0,0,0
"kaggle:titanic","vec_recycle",10,5,5,1,4,4,1,0,0,0,1,3,0,0,0,0,0,0
"kaggle:titanic","rotate_just",137,93,48,34,59,31,33,1,0,28,53,4,4,0,4,0,0,0
"kaggle:titanic","titleGrob",344,210,140,27,183,98,26,1,0,85,165,12,47,2,45,1,1,0
"kaggle:titanic","get",6,6,4,1,5,3,0,1,0,2,2,2,4,1,3,0,1,0
"kaggle:titanic","convertUnit",49,46,20,8,38,15,8,0,0,23,34,2,6,1,5,1,0,0
"kaggle:titanic","width_cm",29,25,12,8,17,2,8,0,0,15,5,1,8,0,8,0,0,0
"kaggle:titanic","as.graphicsAnnot",10,5,5,1,4,1,0,1,0,3,4,0,3,1,2,0,1,0
"kaggle:titanic","neg_to_pos",8,8,1,0,8,1,0,0,0,7,6,0,4,0,4,0,0,0
"kaggle:titanic","get",6,6,4,1,5,3,0,1,0,2,2,2,4,1,3,0,1,0
"kaggle:titanic","FUN",29,25,12,6,19,4,6,0,0,15,5,3,9,0,9,0,0,0
"kaggle:titanic","grobHeight",1,0,0,0,0,0,0,0,0,0,0,0,0,0,0,0,0,0
"kaggle:titanic","eval",8,7,3,1,6,2,1,0,0,4,4,2,3,1,2,1,0,0
"kaggle:titanic","check_number_whole",22,9,3,1,8,1,1,0,0,7,6,0,0,0,0,0,0,0
"kaggle:titanic","getClassDef",60,42,25,1,41,22,1,0,0,19,33,6,6,0,6,0,0,0
"kaggle:titanic","slot",7,4,4,0,4,4,0,0,0,0,0,4,1,0,1,0,0,0
"kaggle:titanic","is.zero",6,6,5,1,5,2,1,0,0,3,2,1,4,0,4,0,0,0
"kaggle:titanic","gtable_add_cols",117,38,14,5,33,7,5,0,0,26,20,3,7,0,7,0,0,0
"kaggle:titanic","get",6,6,4,1,5,3,0,1,0,2,2,2,4,1,3,0,1,0
"kaggle:titanic","f",103,50,33,15,35,16,13,2,0,19,28,2,9,0,9,0,0,0
"kaggle:titanic","arg_match0",12,5,5,0,5,5,0,0,0,0,2,3,1,0,1,0,0,0
"kaggle:titanic","nrow",4,3,3,1,2,2,1,0,0,0,0,2,1,0,1,0,0,0
"kaggle:titanic","valid.charjust",96,65,47,17,48,23,13,4,0,25,47,1,10,2,8,2,0,0
"kaggle:titanic","sort.int",244,99,83,36,63,39,18,18,0,24,59,1,24,9,15,1,8,0
"kaggle:titanic",".doSortWrap",40,22,21,11,11,9,7,4,0,2,10,1,2,2,0,0,2,0
"kaggle:titanic",".makeSortEnum",13,5,4,3,2,2,3,0,0,0,2,0,0,0,0,0,0,0
"kaggle:titanic","matrix",13,11,7,0,11,3,0,0,0,8,10,0,5,0,5,0,0,0
"kaggle:titanic","FUN",1,0,0,0,0,0,0,0,0,0,0,0,0,0,0,0,0,0
"kaggle:titanic","NCOL",9,6,6,3,3,3,2,1,0,0,1,2,2,1,1,0,1,0
"kaggle:titanic","sym",39,27,24,4,23,11,4,0,0,12,14,7,6,0,6,0,0,0
"kaggle:titanic","is_symbolic",8,8,3,2,6,1,2,0,0,5,2,1,5,1,4,1,0,0
"kaggle:titanic","is_call",11,6,6,1,5,5,1,0,0,0,2,3,4,0,4,0,0,0
"kaggle:titanic","node_cdr",5,3,3,0,3,3,0,0,0,0,0,3,2,0,2,0,0,0
"kaggle:titanic","f",5,3,3,1,2,2,1,0,0,0,0,2,0,0,0,0,0,0
"kaggle:titanic","duplicated",1,0,0,0,0,0,0,0,0,0,0,0,0,0,0,0,0,0
"kaggle:titanic","rename_aes",87,43,28,11,32,15,6,5,0,17,25,2,6,1,5,1,0,0
"kaggle:titanic","quo_squash",45,35,21,5,30,7,5,0,0,23,22,2,11,0,11,0,0,0
"kaggle:titanic","is_bare_formula",25,9,6,2,7,4,2,0,0,3,1,4,3,0,3,0,0,0
"kaggle:titanic","is_false",10,10,9,1,9,1,1,0,0,8,8,0,3,0,3,0,0,0
"kaggle:titanic","setdiff",20,16,11,0,16,11,0,0,0,5,12,3,13,0,13,0,0,0
"kaggle:titanic","accessor",1,1,1,1,0,0,0,1,0,0,0,0,1,1,0,0,1,0
"kaggle:titanic","frame_get",42,36,19,3,33,15,3,0,0,18,28,3,4,0,4,0,0,0
"kaggle:titanic","frame_call",24,11,7,0,11,4,0,0,0,7,2,4,2,0,2,0,0,0
"kaggle:titanic","get",6,6,4,1,5,3,0,1,0,2,2,2,4,1,3,0,1,0
"kaggle:titanic","strip_dots",106,59,36,12,47,21,7,5,0,26,35,5,16,1,15,0,1,0
"kaggle:titanic","quo_squash_impl",29,23,14,2,21,5,2,0,0,16,17,1,8,0,8,0,0,0
"kaggle:titanic","defaults",47,30,16,0,30,16,0,0,0,14,26,3,19,0,19,0,0,0
"kaggle:titanic","FUN",14,11,11,4,7,4,4,0,0,3,3,2,4,1,3,1,0,0
"kaggle:titanic","eval_bare",8,5,4,0,5,3,0,0,0,2,2,2,1,0,1,0,0,0
"kaggle:titanic","element_blank",58,29,23,8,21,14,4,4,0,7,17,2,6,2,4,0,2,0
"kaggle:titanic","margin",13,8,1,0,8,0,0,0,0,8,6,0,0,0,0,0,0,0
"kaggle:titanic","new.env",4,4,3,3,1,0,1,2,0,1,0,0,2,2,0,0,2,0
"kaggle:titanic","clone",10,2,2,0,2,2,0,0,0,0,2,0,0,0,0,0,0,0
"kaggle:titanic","FUN",14,8,7,3,5,3,2,1,0,2,3,2,3,0,3,0,0,0
"kaggle:titanic","",7,4,4,1,3,3,1,0,0,0,0,3,1,0,1,0,0,0
"kaggle:titanic","is_column_vec",10,5,5,2,3,2,1,1,0,1,1,2,1,0,1,0,0,0
"kaggle:titanic","is.factor",5,5,4,1,4,1,1,0,0,3,0,1,3,0,3,0,0,0
"kaggle:titanic","is.discrete",8,6,5,2,4,3,2,0,0,1,1,2,2,0,2,0,0,0
"kaggle:titanic","sys.calls",0,0,0,0,0,0,0,0,0,0,0,0,0,0,0,0,0,0
"kaggle:titanic","",14,8,6,1,7,3,0,1,0,4,6,0,3,0,3,0,0,0
"kaggle:titanic","get",6,6,4,1,5,3,0,1,0,2,2,2,4,1,3,0,1,0
"kaggle:titanic","drop_null",10,6,3,1,5,2,1,0,0,3,3,0,4,1,3,1,0,0
"kaggle:titanic","modifyList",153,61,39,21,40,16,4,17,0,24,39,1,24,6,18,2,4,0
"kaggle:titanic","",57,7,4,2,5,2,2,0,0,3,0,2,0,0,0,0,0,0
"kaggle:titanic","setdiff",20,16,11,0,16,11,0,0,0,5,11,3,13,0,13,0,0,0
"kaggle:titanic","get",6,6,4,1,5,3,0,1,0,2,2,2,4,1,3,0,1,0
"kaggle:titanic","",481,165,126,58,107,45,40,18,0,62,94,6,12,4,8,0,4,0
"kaggle:titanic","%||%",4,4,4,2,2,1,2,0,0,1,1,1,3,2,1,2,0,0
"kaggle:titanic","FUN",6,4,2,0,4,2,0,0,0,2,2,1,0,0,0,0,0,0
"kaggle:titanic","flip_data",28,17,15,1,16,2,1,0,0,14,12,1,5,0,5,0,0,0
"kaggle:titanic","diff",1,0,0,0,0,0,0,0,0,0,0,0,0,0,0,0,0,0
"kaggle:titanic","expand_range",15,14,13,7,7,6,7,0,0,1,7,0,0,0,0,0,0,0
"kaggle:titanic","get",6,6,4,1,5,3,0,1,0,2,2,2,4,1,3,0,1,0
"kaggle:titanic","empty",22,20,14,6,14,8,6,0,0,6,6,5,5,0,5,0,0,0
"kaggle:titanic","",46,20,17,6,14,11,3,3,0,3,11,1,2,1,1,0,1,0
"kaggle:titanic","new.env",4,4,3,3,1,0,1,2,0,1,0,0,2,2,0,0,2,0
"kaggle:titanic","list2env",14,13,5,1,12,4,0,1,0,8,12,0,2,1,1,0,1,0
"kaggle:titanic","as_environment",23,13,10,2,11,7,2,0,0,4,5,4,5,0,5,0,0,0
"kaggle:titanic","detect_void_name",10,5,5,2,3,3,1,1,0,0,3,0,5,2,3,1,1,0
"kaggle:titanic","as_quosure",72,37,23,8,29,13,8,0,0,16,10,11,16,1,15,1,0,0
"kaggle:titanic","FUN",15,8,7,2,6,5,2,0,0,1,2,4,3,0,3,0,0,0
"kaggle:titanic","frame_get",42,36,19,3,33,15,3,0,0,18,28,3,4,0,4,0,0,0
"kaggle:titanic","frame_call",24,11,7,0,11,4,0,0,0,7,2,4,2,0,2,0,0,0
"kaggle:titanic","caller_call",28,15,3,1,14,2,1,0,0,12,10,1,1,0,1,0,0,0
"kaggle:titanic","vapply",15,9,8,0,9,8,0,0,0,1,6,3,6,0,6,0,0,0
"kaggle:titanic","get",6,6,4,1,5,3,0,1,0,2,2,2,4,1,3,0,1,0
"kaggle:titanic","is_calculated_aes",5,4,1,0,4,1,0,0,0,3,0,1,0,0,0,0,0,0
"kaggle:titanic","input",32,9,6,0,9,5,0,0,0,4,7,1,4,0,4,0,0,0
"kaggle:titanic","setdiff",20,16,11,0,16,11,0,0,0,5,11,3,13,0,13,0,0,0
"kaggle:titanic","FUN",7,6,4,0,6,4,0,0,0,2,2,3,2,0,2,0,0,0
"kaggle:titanic","lapply",15,14,9,0,14,9,0,0,0,5,11,3,9,0,9,0,0,0
"kaggle:titanic","vapply",17,11,9,0,11,8,0,0,0,3,6,3,7,0,7,0,0,0
"kaggle:titanic","get",6,6,4,1,5,3,0,1,0,2,2,2,4,1,3,0,1,0
"kaggle:titanic","check_required_aesthetics",94,41,24,5,36,15,4,1,0,21,33,2,16,2,14,1,1,0
"kaggle:titanic","get",6,6,4,1,5,3,0,1,0,2,2,2,4,1,3,0,1,0
"kaggle:titanic","new_transform",90,53,33,8,45,24,4,4,0,21,42,2,6,2,4,0,2,0
"kaggle:titanic","transform_identity",1,1,1,0,1,1,0,0,0,0,0,1,0,0,0,0,0,0
"kaggle:titanic","extended_breaks",1,1,1,0,1,0,0,0,0,1,0,0,0,0,0,0,0,0
"kaggle:titanic","seq",1,0,0,0,0,0,0,0,0,0,0,0,0,0,0,0,0,0
"kaggle:titanic","regular_minor_breaks",0,0,0,0,0,0,0,0,0,0,0,0,0,0,0,0,0,0
"kaggle:titanic","format_format",1,1,0,0,1,0,0,0,0,1,0,0,0,0,0,0,0,0
"kaggle:titanic","is_discrete",0,0,0,0,0,0,0,0,0,0,0,0,0,0,0,0,0,0
"kaggle:titanic","censor",32,20,20,6,14,10,3,1,2,4,12,1,3,2,1,0,0,2
"kaggle:titanic","inherits",3,3,3,0,3,3,0,0,0,0,0,3,2,0,2,0,0,0
"kaggle:titanic","is_guide",5,5,4,1,4,1,1,0,0,3,0,1,2,0,2,0,0,0
"kaggle:titanic","new.env",4,4,3,3,1,0,1,2,0,1,0,0,2,2,0,0,2,0
"kaggle:titanic","new_guide",154,78,40,6,72,32,2,4,0,40,64,6,19,0,19,0,0,0
"kaggle:titanic","ggproto",65,25,18,6,19,9,4,2,0,10,14,2,8,3,5,1,2,0
"kaggle:titanic","check_subclass",45,30,17,6,24,9,5,1,0,15,13,5,6,1,5,0,1,0
"kaggle:titanic","fun",21,7,3,0,7,3,0,0,0,4,5,0,0,0,0,0,0,0
"kaggle:titanic","FUN",125,79,43,15,64,22,13,2,0,42,50,3,29,1,28,1,0,0
"kaggle:titanic","as_string",30,19,18,2,17,12,2,0,0,5,8,5,5,0,5,0,0,0
"kaggle:titanic","transform",16,12,2,0,12,2,0,0,0,10,12,0,0,0,0,0,0,0
"kaggle:titanic","is_list",7,4,4,1,3,3,1,0,0,0,2,1,1,0,1,0,0,0
"kaggle:titanic","vapply",15,9,8,0,9,8,0,0,0,1,6,3,6,0,6,0,0,0
"kaggle:titanic","get",6,6,4,1,5,3,0,1,0,2,2,2,4,1,3,0,1,0
"kaggle:titanic","is_scaled_aes",4,4,1,0,4,1,0,0,0,3,0,1,0,0,0,0,0,0
"kaggle:titanic","get",6,6,4,1,5,3,0,1,0,2,2,2,4,1,3,0,1,0
"kaggle:titanic","is_staged_aes",4,4,1,0,4,1,0,0,0,3,0,1,1,0,1,0,0,0
"kaggle:titanic","check_aesthetics",21,10,9,5,5,2,5,0,0,3,4,0,0,0,0,0,0,0
"kaggle:titanic","FUN",33,24,15,7,17,6,7,0,0,11,6,4,11,1,10,1,0,0
"kaggle:titanic","get_breaks",3,2,1,0,2,1,0,0,0,1,0,1,1,0,1,0,0,0
"kaggle:titanic","arg_match0",12,5,5,0,5,5,0,0,0,0,2,3,1,0,1,0,0,0
"kaggle:titanic","endots",214,57,41,13,44,18,8,5,0,26,36,5,10,0,10,0,0,0
"kaggle:titanic","unknown--fromConstant",13,6,4,0,6,4,0,0,0,2,2,3,1,0,1,0,0,0
"kaggle:titanic","names2",7,4,4,0,4,4,0,0,0,0,2,2,1,0,1,0,0,0
"kaggle:titanic","FUN",50,28,19,2,26,7,1,1,0,19,18,2,5,0,5,0,0,0
"kaggle:titanic","get",6,6,4,1,5,3,0,1,0,2,2,2,4,1,3,0,1,0
"kaggle:titanic","calc_element",99,51,25,5,46,16,4,1,0,30,39,3,13,1,12,0,1,0
"kaggle:titanic","convertHeight",4,4,1,0,4,1,0,0,0,3,0,1,1,0,1,0,0,0
"kaggle:titanic","check_string",37,12,9,3,9,4,3,0,0,5,3,3,2,0,2,0,0,0
"kaggle:titanic","NCOL",9,6,6,2,4,4,2,0,0,0,1,3,2,0,2,0,0,0
"kaggle:titanic","is.zero",6,6,3,1,5,2,1,0,0,3,2,1,4,0,4,0,0,0
"kaggle:titanic","FUN",3,3,3,1,2,2,1,0,0,0,2,0,0,0,0,0,0,0
"kaggle:titanic","unknown--fromConstant",12,7,6,0,7,6,0,0,0,1,4,3,2,0,2,0,0,0
"kaggle:titanic","find_panel",23,5,4,0,5,4,0,0,0,1,4,1,0,0,0,0,0,0
"kaggle:titanic","gtable_add_rows",117,38,14,5,33,7,5,0,0,26,20,3,8,0,8,0,0,0
"kaggle:titanic","gtable_add_cols",117,38,14,5,33,7,5,0,0,26,20,3,7,0,7,0,0,0
"kaggle:titanic","valid.layout",93,43,32,7,36,19,5,2,0,17,30,4,8,0,8,0,0,0
"kaggle:titanic","vpname",22,16,4,0,16,4,0,0,0,12,12,2,1,0,1,0,0,0
"kaggle:titanic","colnames",28,19,17,4,15,8,3,1,0,7,5,5,8,1,7,0,1,0
"kaggle:titanic","NCOL",9,6,5,3,3,3,2,1,0,0,1,2,2,1,1,0,1,0
"kaggle:titanic","colnames",28,19,17,4,15,8,3,1,0,7,5,5,8,1,7,0,1,0
"kaggle:titanic","NCOL",9,6,5,3,3,3,2,1,0,0,1,2,2,1,1,0,1,0
"kaggle:titanic","FUN",25,24,18,2,22,8,2,0,0,14,19,1,4,0,4,0,0,0
"kaggle:titanic","formula",1,0,0,0,0,0,0,0,0,0,0,0,0,0,0,0,0,0
"kaggle:titanic","as.data.frame",4,1,1,0,1,1,0,0,0,0,0,1,1,0,1,0,0,0
"kaggle:titanic","apply",375,137,122,64,73,37,37,27,0,36,66,3,55,27,28,2,25,0
"kaggle:titanic","get",6,6,4,1,5,3,0,1,0,2,2,2,4,1,3,0,1,0
"kaggle:titanic","levels",1,0,0,0,0,0,0,0,0,0,0,0,0,0,0,0,0,0
"kaggle:titanic","FUN",5,3,3,2,1,1,1,1,0,0,0,1,1,1,0,0,1,0
"kaggle:titanic","substring",38,23,23,12,11,9,4,8,0,2,9,2,11,8,3,0,8,0
"kaggle:titanic","row.names<-",1,0,0,0,0,0,0,0,0,0,0,0,0,0,0,0,0,0
"kaggle:titanic","as.data.frame",4,1,1,0,1,1,0,0,0,0,0,1,1,0,1,0,0,0
"kaggle:titanic","matrix",13,11,9,0,11,8,0,0,0,3,10,1,6,0,6,0,0,0
"kaggle:titanic","row.names",1,0,0,0,0,0,0,0,0,0,0,0,0,0,0,0,0,0
"kaggle:titanic","deparse",11,11,6,1,10,5,1,0,0,5,9,0,2,0,2,0,0,0
"kaggle:titanic","is.ordered",5,5,2,1,4,1,1,0,0,3,0,1,3,0,3,0,0,0
"kaggle:titanic","array",53,7,7,3,4,1,1,2,0,3,4,0,5,3,2,1,2,0
"kaggle:titanic","var",41,30,20,6,24,6,6,0,0,18,15,3,6,0,6,0,0,0
"kaggle:titanic","FUN",363,42,30,11,31,12,7,4,0,19,24,2,3,0,3,0,0,0
"kaggle:titanic","mode",16,13,10,4,9,4,1,3,1,5,7,0,4,2,2,1,1,1
"kaggle:titanic","data.class",19,11,10,4,7,4,2,2,0,3,5,2,3,1,2,0,1,0
"kaggle:titanic","strrep",10,5,5,1,4,4,0,1,0,0,2,2,1,1,0,0,1,0
"kaggle:titanic","FUN",12,3,3,2,1,1,2,0,0,0,0,1,0,0,0,0,0,0
"kaggle:titanic","vapply",17,11,9,0,11,8,0,0,0,3,6,3,7,0,7,0,0,0
"kaggle:titanic",".identC",7,4,4,1,3,3,1,0,0,0,2,1,2,0,2,0,0,0
"kaggle:titanic",".identC",7,4,4,1,3,3,1,0,0,0,2,1,2,0,2,0,0,0
"kaggle:titanic","get",6,6,4,1,5,3,0,1,0,2,2,2,4,1,3,0,1,0
"kaggle:titanic","extends",116,72,55,23,49,27,15,8,0,22,44,4,9,2,7,2,0,0
"kaggle:titanic","possibleExtends",72,33,22,8,25,9,6,2,0,16,22,2,4,0,4,0,0,0
"kaggle:titanic","getClassDef",60,42,25,1,41,22,1,0,0,19,31,8,12,0,12,0,0,0
"kaggle:titanic","FUN",14,9,8,4,5,3,3,1,0,2,4,1,4,1,3,0,1,0
"kaggle:titanic","split",1,0,0,0,0,0,0,0,0,0,0,0,0,0,0,0,0,0
"kaggle:titanic","FUN",22,11,8,3,8,4,1,2,0,4,7,1,0,0,0,0,0,0
"kaggle:titanic","ifelse",105,58,56,25,33,22,14,11,0,11,28,3,27,14,13,6,8,0
"kaggle:titanic","makepredictcall",1,0,0,0,0,0,0,0,0,0,0,0,0,0,0,0,0,0
"kaggle:titanic","FUN",5,4,3,2,2,1,2,0,0,1,0,1,2,0,2,0,0,0
"kaggle:titanic","numeric",1,1,1,0,1,1,0,0,0,0,0,1,1,0,1,0,0,0
"kaggle:titanic","get",6,6,4,1,5,3,0,1,0,2,2,2,4,1,3,0,1,0
"kaggle:titanic","ctrfn",128,53,37,18,35,13,8,10,1,22,33,2,5,4,1,1,3,1
"kaggle:titanic","contrasts",67,30,24,7,23,9,7,0,0,14,19,1,2,1,1,1,0,0
"kaggle:titanic","mode",17,14,12,4,10,4,1,3,0,6,7,0,5,2,3,1,1,0
"kaggle:titanic","data.class",19,11,10,4,7,4,2,2,0,3,3,3,4,1,3,0,1,0
"kaggle:titanic","getClassDef",60,42,25,1,41,22,1,0,0,19,31,8,12,0,12,0,0,0
"kaggle:titanic","is",124,56,42,18,38,18,10,8,0,20,32,4,15,4,11,1,3,0
"kaggle:titanic",".requirePackage",43,12,10,2,10,6,1,1,0,4,9,1,0,0,0,0,0,0
"kaggle:titanic","FUN",4,3,2,0,3,2,0,0,0,1,2,0,2,0,2,0,0,0
"kaggle:titanic","FUN",4,3,2,0,3,2,0,0,0,1,2,0,0,0,0,0,0,0
"kaggle:titanic","FUN",4,3,2,0,3,2,0,0,0,1,2,0,0,0,0,0,0,0
"kaggle:titanic","FUN",4,3,2,0,3,2,0,0,0,1,2,0,0,0,0,0,0,0
"kaggle:titanic","FUN",4,3,2,0,3,2,0,0,0,1,2,0,0,0,0,0,0,0
"kaggle:titanic","FUN",4,3,2,0,3,2,0,0,0,1,2,0,0,0,0,0,0,0
"kaggle:titanic","FUN",4,3,2,0,3,2,0,0,0,1,2,0,0,0,0,0,0,0
"kaggle:titanic","FUN",4,3,2,0,3,2,0,0,0,1,2,0,0,0,0,0,0,0
"kaggle:titanic","FUN",4,3,2,0,3,2,0,0,0,1,2,0,0,0,0,0,0,0
"kaggle:titanic","FUN",22,11,8,3,8,4,1,2,0,4,6,2,0,0,0,0,0,0
"kaggle:titanic","FUN",4,3,2,0,3,2,0,0,0,1,2,0,0,0,0,0,0,0
"kaggle:titanic","URapply",17,14,11,3,11,8,1,2,0,3,7,3,2,0,2,0,0,0
"kaggle:titanic","unlist",27,24,15,0,24,14,0,0,0,10,21,1,2,0,2,0,0,0
"kaggle:titanic","structure",55,26,21,8,18,13,4,4,0,5,17,1,6,2,4,0,2,0
"kaggle:titanic","FUN",38,14,6,1,13,5,1,0,0,8,7,2,0,0,0,0,0,0
"kaggle:titanic","sample.int",16,13,5,0,13,5,0,0,0,8,13,0,0,0,0,0,0,0
"kaggle:titanic","formula",1,0,0,0,0,0,0,0,0,0,0,0,0,0,0,0,0,0
"kaggle:titanic","is.ordered",5,5,4,1,4,1,1,0,0,3,0,1,3,0,3,0,0,0
"kaggle:titanic","rep.int",2,2,2,2,0,0,1,1,0,0,0,0,2,2,0,1,1,0
"kaggle:titanic","array",53,14,13,6,8,2,0,5,1,6,8,0,6,4,2,0,3,1
"kaggle:titanic","sample",35,17,6,2,15,4,2,0,0,11,12,2,2,0,2,0,0,0
"kaggle:titanic","sample.int",16,13,5,0,13,5,0,0,0,8,13,0,0,0,0,0,0,0
"kaggle:titanic","FUN",3,3,1,0,3,1,0,0,0,2,0,1,2,0,2,0,0,0
"kaggle:titanic","sample.int",16,13,5,0,13,5,0,0,0,8,13,0,0,0,0,0,0,0
"kaggle:titanic","str2lang",1,1,1,0,1,1,0,0,0,0,0,1,0,0,0,0,0,0
"kaggle:titanic","FUN",5,4,3,2,2,1,2,0,0,1,0,1,2,0,2,0,0,0
"kaggle:titanic","isTRUE",11,8,5,4,4,3,4,0,0,1,3,1,2,1,1,1,0,0
"kaggle:titanic","isSymmetric.matrix",93,55,30,11,44,11,10,1,0,33,42,1,0,0,0,0,0,0
"kaggle:titanic","withOneRestart",26,15,7,1,14,5,0,1,0,9,12,1,0,0,0,0,0,0
"kaggle:titanic","",17,15,10,4,11,5,3,1,0,6,5,2,2,1,1,0,1,0
"kaggle:titanic","findRestart",36,8,7,3,5,4,1,2,0,1,3,1,0,0,0,0,0,0
"kaggle:titanic","matrix",13,11,10,2,9,7,1,1,0,2,8,1,6,2,4,1,1,0
"kaggle:titanic","getClassDef",60,42,25,1,41,22,1,0,0,19,31,8,12,0,12,0,0,0
"kaggle:titanic","getClass",16,8,5,1,7,3,1,0,0,4,4,0,3,0,3,0,0,0
"kaggle:titanic","FUN",4,3,2,0,3,2,0,0,0,1,2,0,0,0,0,0,0,0
"kaggle:titanic","FUN",4,3,2,0,3,2,0,0,0,1,2,0,0,0,0,0,0,0
"kaggle:titanic","FUN",4,3,2,0,3,2,0,0,0,1,2,0,0,0,0,0,0,0
"kaggle:titanic","FUN",4,3,2,0,3,2,0,0,0,1,2,0,2,0,2,0,0,0
"kaggle:titanic","FUN",4,3,2,0,3,2,0,0,0,1,2,0,2,0,2,0,0,0
"kaggle:titanic","FUN",4,3,2,0,3,2,0,0,0,1,2,0,0,0,0,0,0,0
"kaggle:titanic","FUN",4,3,2,0,3,2,0,0,0,1,2,0,0,0,0,0,0,0
"kaggle:titanic","FUN",4,3,2,0,3,2,0,0,0,1,2,0,0,0,0,0,0,0
"kaggle:titanic","FUN",4,3,2,0,3,2,0,0,0,1,2,0,0,0,0,0,0,0
"kaggle:titanic","FUN",4,3,2,0,3,2,0,0,0,1,2,0,0,0,0,0,0,0
"kaggle:titanic","ncol",4,3,3,0,3,3,0,0,0,0,2,1,3,0,3,0,0,0
"kaggle:titanic","unlist",27,24,15,0,24,15,0,0,0,9,21,1,2,0,2,0,0,0
"kaggle:titanic","Sys.getenv",59,19,19,8,11,7,5,3,0,4,10,0,3,2,1,1,1,0
"kaggle:titanic","unknown--fromConstant",5,4,4,0,4,3,0,0,0,1,2,2,1,0,1,0,0,0
"kaggle:titanic","asMethod",2,2,1,0,2,1,0,0,0,1,0,1,0,0,0,0,0,0
"kaggle:titanic","asMethod",16,10,9,1,9,7,1,0,0,2,3,5,0,0,0,0,0,0
"kaggle:titanic","backticks",3,3,1,0,3,1,0,0,0,2,2,0,0,0,0,0,0,0
"kaggle:titanic","formula",1,0,0,0,0,0,0,0,0,0,0,0,0,0,0,0,0,0
"kaggle:titanic","terms",1,0,0,0,0,0,0,0,0,0,0,0,0,0,0,0,0,0
"kaggle:titanic","FUN",363,42,30,10,32,13,6,4,0,19,25,2,7,0,7,0,0,0
"kaggle:titanic","rev",1,0,0,0,0,0,0,0,0,0,0,0,0,0,0,0,0,0
"kaggle:titanic","isSymmetric.matrix",93,55,30,11,44,11,10,1,0,33,42,1,0,0,0,0,0,0
"kaggle:titanic","eigen",155,84,66,17,67,35,12,5,0,32,54,8,19,3,16,0,3,0
"kaggle:titanic","unname",17,15,13,2,13,9,2,0,0,4,6,4,9,0,9,0,0,0
"kaggle:titanic","parent.frame",1,1,1,1,0,0,0,1,0,0,0,0,1,1,0,0,1,0
"kaggle:titanic","parent.frame",1,1,1,1,0,0,0,1,0,0,0,0,1,1,0,0,1,0
"kaggle:titanic","get",6,6,4,1,5,3,0,1,0,2,2,2,4,1,3,0,1,0
"kaggle:titanic","ma_exists",38,29,21,4,25,11,4,0,0,14,25,0,0,0,0,0,0,0
"kaggle:titanic","anyDuplicated",1,0,0,0,0,0,0,0,0,0,0,0,0,0,0,0,0,0
"kaggle:titanic","data.row.names",11,4,4,1,3,3,1,0,0,0,2,1,2,0,2,0,0,0
"kaggle:titanic","Matrix",190,50,41,20,30,14,19,1,0,16,24,4,2,0,2,0,0,0
"kaggle:titanic","isTriangular",1,1,1,1,0,0,1,0,0,0,0,0,0,0,0,0,0,0
"kaggle:titanic","isSymmetric",1,1,1,1,0,0,1,0,0,0,0,0,0,0,0,0,0,0
"kaggle:titanic","rangerCpp",107,54,54,0,54,54,0,0,0,0,48,6,0,0,0,0,0,0
"kaggle:titanic","runif",9,5,5,1,4,4,1,0,0,0,2,2,0,0,0,0,0,0
"kaggle:titanic","FUN",4,3,2,0,3,2,0,0,0,1,2,0,0,0,0,0,0,0
"kaggle:titanic","FUN",4,3,2,0,3,2,0,0,0,1,2,0,0,0,0,0,0,0
"kaggle:titanic","FUN",4,3,2,0,3,2,0,0,0,1,2,0,0,0,0,0,0,0
"kaggle:titanic","FUN",4,3,2,0,3,2,0,0,0,1,2,0,0,0,0,0,0,0
"kaggle:titanic","FUN",4,3,2,0,3,2,0,0,0,1,2,0,0,0,0,0,0,0
"kaggle:titanic","FUN",4,3,2,0,3,2,0,0,0,1,2,0,0,0,0,0,0,0
"kaggle:titanic","FUN",4,3,2,0,3,2,0,0,0,1,2,0,0,0,0,0,0,0
"kaggle:titanic","FUN",4,3,2,0,3,2,0,0,0,1,2,0,2,0,2,0,0,0
"kaggle:titanic","FUN",4,3,2,0,3,2,0,0,0,1,2,0,0,0,0,0,0,0
"kaggle:titanic","FUN",4,3,2,0,3,2,0,0,0,1,2,0,0,0,0,0,0,0
"kaggle:titanic","apply",375,156,131,63,93,49,41,22,0,44,84,3,58,23,35,3,20,0
"kaggle:titanic","levels",1,0,0,0,0,0,0,0,0,0,0,0,0,0,0,0,0,0
"kaggle:titanic","get",6,6,4,1,5,3,0,1,0,2,2,2,4,1,3,0,1,0
"kaggle:titanic","FUN",20,11,8,3,8,2,3,0,0,6,2,2,3,0,3,0,0,0
"kaggle:titanic","Make.row.names",48,21,18,6,15,6,5,1,0,9,13,1,2,0,2,0,0,0
"kaggle:titanic","var",41,30,20,6,24,6,6,0,0,18,15,3,6,0,6,0,0,0
"kaggle:titanic","unlist",27,24,15,1,23,14,0,1,0,9,20,1,2,1,1,0,1,0
"kaggle:titanic","FUN",4,3,2,0,3,2,0,0,0,1,2,0,0,0,0,0,0,0
"kaggle:titanic","FUN",4,3,2,0,3,2,0,0,0,1,2,0,2,0,2,0,0,0
"kaggle:titanic","FUN",4,3,2,0,3,2,0,0,0,1,2,0,0,0,0,0,0,0
"kaggle:titanic","FUN",4,3,2,0,3,2,0,0,0,1,2,0,0,0,0,0,0,0
"kaggle:titanic","FUN",4,3,2,0,3,2,0,0,0,1,2,0,0,0,0,0,0,0
"kaggle:titanic","FUN",4,3,2,0,3,2,0,0,0,1,2,0,0,0,0,0,0,0
"kaggle:titanic","FUN",4,3,2,0,3,2,0,0,0,1,2,0,0,0,0,0,0,0
"kaggle:titanic","FUN",4,3,2,0,3,2,0,0,0,1,2,0,0,0,0,0,0,0
"kaggle:titanic","FUN",4,3,2,0,3,2,0,0,0,1,2,0,0,0,0,0,0,0
"kaggle:titanic","FUN",4,3,2,0,3,2,0,0,0,1,2,0,0,0,0,0,0,0
"kaggle:titanic","t",1,0,0,0,0,0,0,0,0,0,0,0,0,0,0,0,0,0
"kaggle:titanic","as.matrix",1,0,0,0,0,0,0,0,0,0,0,0,0,0,0,0,0,0
"kaggle:titanic","data.matrix",151,9,7,2,7,3,2,0,0,4,3,1,3,0,3,0,0,0
"kaggle:titanic","FUN",4,3,2,0,3,2,0,0,0,1,2,0,0,0,0,0,0,0
"kaggle:titanic","FUN",4,3,2,0,3,2,0,0,0,1,2,0,0,0,0,0,0,0
"kaggle:titanic","FUN",4,3,2,0,3,2,0,0,0,1,2,0,0,0,0,0,0,0
"kaggle:titanic","FUN",4,3,2,0,3,2,0,0,0,1,2,0,0,0,0,0,0,0
"kaggle:titanic","FUN",4,3,2,0,3,2,0,0,0,1,2,0,2,0,2,0,0,0
"kaggle:titanic","FUN",4,3,2,0,3,2,0,0,0,1,2,0,0,0,0,0,0,0
"kaggle:titanic","FUN",4,3,2,0,3,2,0,0,0,1,2,0,0,0,0,0,0,0
"kaggle:titanic","FUN",4,3,2,0,3,2,0,0,0,1,2,0,0,0,0,0,0,0
"kaggle:titanic","FUN",4,3,2,0,3,2,0,0,0,1,2,0,0,0,0,0,0,0
"kaggle:titanic","FUN",4,3,2,0,3,2,0,0,0,1,2,0,0,0,0,0,0,0
"kaggle:titanic","URapply",4,4,2,1,3,1,1,0,0,2,2,0,1,0,1,0,0,0
"kaggle:titanic","factor",93,55,45,15,40,27,10,5,0,13,34,3,20,3,17,1,2,0
"kaggle:titanic","array",53,14,12,3,11,4,0,3,0,7,10,1,6,1,5,0,1,0
"kaggle:titanic","colnames",28,19,17,4,15,8,3,1,0,7,5,5,8,1,7,0,1,0
"kaggle:titanic","NCOL",9,6,5,3,3,3,2,1,0,0,1,2,2,1,1,0,1,0
"kaggle:titanic","reformulate",33,20,13,4,16,8,2,2,0,8,10,3,2,0,2,0,0,0
"kaggle:titanic","sampler.univ",259,154,109,49,105,57,33,16,0,48,88,9,27,1,26,0,1,0
"kaggle:titanic","model.matrix",1,0,0,0,0,0,0,0,0,0,0,0,0,0,0,0,0,0
"kaggle:titanic","terms",1,0,0,0,0,0,0,0,0,0,0,0,0,0,0,0,0,0
"kaggle:titanic","update",1,0,0,0,0,0,0,0,0,0,0,0,0,0,0,0,0,0
"kaggle:titanic","model.frame",1,0,0,0,0,0,0,0,0,0,0,0,0,0,0,0,0,0
"kaggle:titanic","labels",1,0,0,0,0,0,0,0,0,0,0,0,0,0,0,0,0,0
"kaggle:titanic","paste",4,4,4,4,0,0,1,3,0,0,0,0,2,2,0,0,2,0
"kaggle:titanic","formula",1,0,0,0,0,0,0,0,0,0,0,0,0,0,0,0,0,0
"kaggle:titanic","fixFormulaObject",161,46,37,9,37,26,7,2,0,11,31,3,2,0,2,0,0,0
"kaggle:titanic","terms",1,0,0,0,0,0,0,0,0,0,0,0,0,0,0,0,0,0
"kaggle:titanic","%||%",3,2,2,2,0,0,0,2,0,0,0,0,0,0,0,0,0,0
"kaggle:titanic","paste",4,4,4,4,0,0,1,3,0,0,0,0,2,2,0,0,2,0
"kaggle:titanic","get",6,6,4,0,6,4,0,0,0,2,2,3,4,0,4,0,0,0
"kaggle:titanic","assign",6,6,4,0,6,4,0,0,0,2,3,3,1,0,1,0,0,0
"kaggle:titanic","var",41,30,20,6,24,6,6,0,0,18,15,3,6,0,6,0,0,0
"kaggle:titanic","isSymmetric.matrix",93,55,30,11,44,12,10,1,0,32,42,1,0,0,0,0,0,0
"kaggle:titanic","eigen",155,84,66,17,67,35,12,5,0,32,54,8,19,3,16,0,3,0
"kaggle:titanic","eigen",155,84,66,17,67,35,12,5,0,32,54,8,19,3,16,0,3,0
"kaggle:titanic","remove.lindep",235,127,82,31,96,47,27,4,0,49,89,2,9,2,7,0,2,0
"kaggle:titanic","updateLog",64,46,17,3,43,14,3,0,0,29,36,4,6,1,5,1,0,0
"kaggle:titanic","",1,0,0,0,0,0,0,0,0,0,0,0,0,0,0,0,0,0
"kaggle:titanic","unlist",27,24,15,1,23,14,0,1,0,9,20,1,2,1,1,0,1,0
"kaggle:titanic","unlist",27,24,15,1,23,14,0,1,0,9,20,1,2,1,1,0,1,0
"kaggle:titanic","structure",55,26,21,8,18,13,4,4,0,5,17,1,6,2,4,0,2,0
"kaggle:titanic","simplify2array",124,45,31,15,30,12,9,6,0,18,29,1,11,4,7,0,4,0
"kaggle:titanic","array",53,14,9,6,8,1,1,5,0,7,8,0,6,4,2,1,3,0
"kaggle:titanic","match.names",35,11,9,1,10,2,1,0,0,8,10,0,2,0,2,0,0,0
"kaggle:titanic","make.unique",2,2,2,1,1,1,0,1,0,0,0,1,0,0,0,0,0,0
"kaggle:titanic","tabulate",28,20,17,3,17,10,1,2,0,7,14,1,3,0,3,0,0,0
"kaggle:titanic","FUN",4,3,2,0,3,2,0,0,0,1,2,0,0,0,0,0,0,0
"kaggle:titanic","FUN",4,3,2,0,3,2,0,0,0,1,2,0,0,0,0,0,0,0
"kaggle:titanic","FUN",4,3,2,0,3,2,0,0,0,1,2,0,0,0,0,0,0,0
"kaggle:titanic","FUN",4,3,2,0,3,2,0,0,0,1,2,0,0,0,0,0,0,0
"kaggle:titanic","FUN",4,3,2,0,3,2,0,0,0,1,2,0,0,0,0,0,0,0
"kaggle:titanic","FUN",4,3,2,0,3,2,0,0,0,1,2,0,0,0,0,0,0,0
"kaggle:titanic","FUN",4,3,2,0,3,2,0,0,0,1,2,0,0,0,0,0,0,0
"kaggle:titanic","FUN",4,3,2,0,3,2,0,0,0,1,2,0,0,0,0,0,0,0
"kaggle:titanic","FUN",4,3,2,0,3,2,0,0,0,1,2,0,0,0,0,0,0,0
"kaggle:titanic","FUN",4,3,2,0,3,2,0,0,0,1,2,0,0,0,0,0,0,0
"kaggle:titanic","FUN",4,3,2,0,3,2,0,0,0,1,2,0,0,0,0,0,0,0
"kaggle:titanic","FUN",4,3,2,0,3,2,0,0,0,1,2,0,0,0,0,0,0,0
"kaggle:titanic","FUN",4,3,2,0,3,2,0,0,0,1,2,0,0,0,0,0,0,0
"kaggle:titanic","FUN",4,3,2,0,3,2,0,0,0,1,2,0,0,0,0,0,0,0
"kaggle:titanic","FUN",4,3,2,0,3,2,0,0,0,1,2,0,0,0,0,0,0,0
"kaggle:titanic","FUN",4,3,2,0,3,2,0,0,0,1,2,0,0,0,0,0,0,0
"kaggle:titanic","FUN",4,3,2,0,3,2,0,0,0,1,2,0,0,0,0,0,0,0
"kaggle:titanic","FUN",4,3,2,0,3,2,0,0,0,1,2,0,0,0,0,0,0,0
"kaggle:titanic","FUN",4,3,2,0,3,2,0,0,0,1,2,0,0,0,0,0,0,0
"kaggle:titanic","FUN",4,3,2,0,3,2,0,0,0,1,2,0,0,0,0,0,0,0
"kaggle:titanic","ncol",4,3,3,1,2,2,0,1,0,0,1,1,3,1,2,0,1,0
"kaggle:titanic","rangerCpp",107,54,54,0,54,54,0,0,0,0,48,6,0,0,0,0,0,0
"kaggle:titanic","FUN",4,3,2,0,3,2,0,0,0,1,2,0,0,0,0,0,0,0
"kaggle:titanic","FUN",4,3,2,0,3,2,0,0,0,1,2,0,0,0,0,0,0,0
"kaggle:titanic","FUN",4,3,2,0,3,2,0,0,0,1,2,0,0,0,0,0,0,0
"kaggle:titanic","FUN",4,3,2,0,3,2,0,0,0,1,2,0,0,0,0,0,0,0
"kaggle:titanic","FUN",4,3,2,0,3,2,0,0,0,1,2,0,0,0,0,0,0,0
"kaggle:titanic","FUN",4,3,2,0,3,2,0,0,0,1,2,0,0,0,0,0,0,0
"kaggle:titanic","FUN",4,3,2,0,3,2,0,0,0,1,2,0,0,0,0,0,0,0
"kaggle:titanic","FUN",4,3,2,0,3,2,0,0,0,1,2,0,0,0,0,0,0,0
"kaggle:titanic","FUN",4,3,2,0,3,2,0,0,0,1,2,0,0,0,0,0,0,0
"kaggle:titanic","FUN",4,3,2,0,3,2,0,0,0,1,2,0,0,0,0,0,0,0
"kaggle:titanic","droplevels",1,0,0,0,0,0,0,0,0,0,0,0,0,0,0,0,0,0
"kaggle:titanic","FUN",4,3,2,0,3,2,0,0,0,1,2,0,2,0,2,0,0,0
"kaggle:titanic","FUN",4,3,2,0,3,2,0,0,0,1,2,0,0,0,0,0,0,0
"kaggle:titanic","FUN",4,3,2,0,3,2,0,0,0,1,2,0,0,0,0,0,0,0
"kaggle:titanic","FUN",4,3,2,0,3,2,0,0,0,1,2,0,0,0,0,0,0,0
"kaggle:titanic","FUN",4,3,2,0,3,2,0,0,0,1,2,0,0,0,0,0,0,0
"kaggle:titanic","FUN",4,3,2,0,3,2,0,0,0,1,2,0,0,0,0,0,0,0
"kaggle:titanic","FUN",4,3,2,0,3,2,0,0,0,1,2,0,0,0,0,0,0,0
"kaggle:titanic","FUN",4,3,2,0,3,2,0,0,0,1,2,0,0,0,0,0,0,0
"kaggle:titanic","FUN",4,3,2,0,3,2,0,0,0,1,2,0,0,0,0,0,0,0
"kaggle:titanic","FUN",4,3,2,0,3,2,0,0,0,1,2,0,0,0,0,0,0,0
"kaggle:titanic","FUN",4,3,2,0,3,2,0,0,0,1,2,0,0,0,0,0,0,0
"kaggle:titanic","FUN",4,3,2,0,3,2,0,0,0,1,2,0,0,0,0,0,0,0
"kaggle:titanic","FUN",4,3,2,0,3,2,0,0,0,1,2,0,0,0,0,0,0,0
"kaggle:titanic","FUN",4,3,2,0,3,2,0,0,0,1,2,0,0,0,0,0,0,0
"kaggle:titanic","FUN",4,3,2,0,3,2,0,0,0,1,2,0,0,0,0,0,0,0
"kaggle:titanic","FUN",4,3,2,0,3,2,0,0,0,1,2,0,0,0,0,0,0,0
"kaggle:titanic","FUN",4,3,2,0,3,2,0,0,0,1,2,0,0,0,0,0,0,0
"kaggle:titanic","FUN",4,3,2,0,3,2,0,0,0,1,2,0,0,0,0,0,0,0
"kaggle:titanic","FUN",4,3,2,0,3,2,0,0,0,1,2,0,0,0,0,0,0,0
"kaggle:titanic","FUN",4,3,2,0,3,2,0,0,0,1,2,0,2,0,2,0,0,0
"kaggle:titanic","colMeans",95,45,42,20,25,18,16,4,0,7,19,3,9,2,7,0,2,0
"kaggle:titanic","paste",4,4,4,4,0,0,1,3,0,0,0,0,2,2,0,0,2,0
"kaggle:titanic","formula",1,0,0,0,0,0,0,0,0,0,0,0,0,0,0,0,0,0
"kaggle:titanic","fixFormulaObject",157,42,35,9,33,24,7,2,0,9,31,2,0,0,0,0,0,0
"kaggle:titanic","FUN",4,3,2,0,3,2,0,0,0,1,2,0,0,0,0,0,0,0
"kaggle:titanic","FUN",4,3,2,0,3,2,0,0,0,1,2,0,2,0,2,0,0,0
"kaggle:titanic","FUN",4,3,2,0,3,2,0,0,0,1,2,0,0,0,0,0,0,0
"kaggle:titanic","FUN",4,3,2,0,3,2,0,0,0,1,2,0,0,0,0,0,0,0
"kaggle:titanic","FUN",4,3,2,0,3,2,0,0,0,1,2,0,0,0,0,0,0,0
"kaggle:titanic","FUN",4,3,2,0,3,2,0,0,0,1,2,0,0,0,0,0,0,0
"kaggle:titanic","FUN",4,3,2,0,3,2,0,0,0,1,2,0,0,0,0,0,0,0
"kaggle:titanic","FUN",4,3,2,0,3,2,0,0,0,1,2,0,0,0,0,0,0,0
"kaggle:titanic","FUN",4,3,2,0,3,2,0,0,0,1,2,0,0,0,0,0,0,0
"kaggle:titanic","FUN",4,3,2,0,3,2,0,0,0,1,2,0,0,0,0,0,0,0
"kaggle:titanic","FUN",4,3,2,0,3,2,0,0,0,1,2,0,0,0,0,0,0,0
"kaggle:titanic","FUN",4,3,2,0,3,2,0,0,0,1,2,0,0,0,0,0,0,0
"kaggle:titanic","FUN",4,3,2,0,3,2,0,0,0,1,2,0,0,0,0,0,0,0
"kaggle:titanic","FUN",4,3,2,0,3,2,0,0,0,1,2,0,0,0,0,0,0,0
"kaggle:titanic","FUN",4,3,2,0,3,2,0,0,0,1,2,0,0,0,0,0,0,0
"kaggle:titanic","FUN",4,3,2,0,3,2,0,0,0,1,2,0,0,0,0,0,0,0
"kaggle:titanic","FUN",4,3,2,0,3,2,0,0,0,1,2,0,0,0,0,0,0,0
"kaggle:titanic","FUN",4,3,2,0,3,2,0,0,0,1,2,0,0,0,0,0,0,0
"kaggle:titanic","FUN",4,3,2,0,3,2,0,0,0,1,2,0,0,0,0,0,0,0
"kaggle:titanic","FUN",4,3,2,0,3,2,0,0,0,1,2,0,0,0,0,0,0,0
"kaggle:titanic","factor",93,55,45,15,40,27,10,5,0,13,34,3,20,3,17,1,2,0
"kaggle:titanic","FUN",4,3,2,0,3,2,0,0,0,1,2,0,0,0,0,0,0,0
"kaggle:titanic","FUN",4,3,2,0,3,2,0,0,0,1,2,0,0,0,0,0,0,0
"kaggle:titanic","FUN",4,3,2,0,3,2,0,0,0,1,2,0,0,0,0,0,0,0
"kaggle:titanic","FUN",4,3,2,0,3,2,0,0,0,1,2,0,0,0,0,0,0,0
"kaggle:titanic","FUN",4,3,2,0,3,2,0,0,0,1,2,0,0,0,0,0,0,0
"kaggle:titanic","FUN",4,3,2,0,3,2,0,0,0,1,2,0,0,0,0,0,0,0
"kaggle:titanic","FUN",4,3,2,0,3,2,0,0,0,1,2,0,0,0,0,0,0,0
"kaggle:titanic","FUN",4,3,2,0,3,2,0,0,0,1,2,0,0,0,0,0,0,0
"kaggle:titanic","FUN",4,3,2,0,3,2,0,0,0,1,2,0,0,0,0,0,0,0
"kaggle:titanic","FUN",4,3,2,0,3,2,0,0,0,1,2,0,2,0,2,0,0,0
"kaggle:titanic","FUN",4,3,2,0,3,2,0,0,0,1,2,0,2,0,2,0,0,0
"kaggle:titanic","FUN",4,3,2,0,3,2,0,0,0,1,2,0,0,0,0,0,0,0
"kaggle:titanic","FUN",4,3,2,0,3,2,0,0,0,1,2,0,0,0,0,0,0,0
"kaggle:titanic","FUN",4,3,2,0,3,2,0,0,0,1,2,0,0,0,0,0,0,0
"kaggle:titanic","FUN",4,3,2,0,3,2,0,0,0,1,2,0,0,0,0,0,0,0
"kaggle:titanic","FUN",4,3,2,0,3,2,0,0,0,1,2,0,0,0,0,0,0,0
"kaggle:titanic","FUN",4,3,2,0,3,2,0,0,0,1,2,0,0,0,0,0,0,0
"kaggle:titanic","FUN",4,3,2,0,3,2,0,0,0,1,2,0,0,0,0,0,0,0
"kaggle:titanic","FUN",4,3,2,0,3,2,0,0,0,1,2,0,0,0,0,0,0,0
"kaggle:titanic","FUN",4,3,2,0,3,2,0,0,0,1,2,0,0,0,0,0,0,0
"kaggle:titanic","remove.lindep",235,127,82,31,96,47,27,4,0,49,89,2,9,2,7,0,2,0
"kaggle:titanic","FUN",4,3,2,0,3,2,0,0,0,1,2,0,0,0,0,0,0,0
"kaggle:titanic","FUN",4,3,2,0,3,2,0,0,0,1,2,0,0,0,0,0,0,0
"kaggle:titanic","FUN",4,3,2,0,3,2,0,0,0,1,2,0,2,0,2,0,0,0
"kaggle:titanic","FUN",4,3,2,0,3,2,0,0,0,1,2,0,0,0,0,0,0,0
"kaggle:titanic","FUN",4,3,2,0,3,2,0,0,0,1,2,0,0,0,0,0,0,0
"kaggle:titanic","FUN",4,3,2,0,3,2,0,0,0,1,2,0,0,0,0,0,0,0
"kaggle:titanic","FUN",4,3,2,0,3,2,0,0,0,1,2,0,2,0,2,0,0,0
"kaggle:titanic","FUN",4,3,2,0,3,2,0,0,0,1,2,0,0,0,0,0,0,0
"kaggle:titanic","FUN",4,3,2,0,3,2,0,0,0,1,2,0,0,0,0,0,0,0
"kaggle:titanic","FUN",4,3,2,0,3,2,0,0,0,1,2,0,0,0,0,0,0,0
"kaggle:titanic","FUN",4,3,2,0,3,2,0,0,0,1,2,0,0,0,0,0,0,0
"kaggle:titanic","FUN",4,3,2,0,3,2,0,0,0,1,2,0,0,0,0,0,0,0
"kaggle:titanic","FUN",4,3,2,0,3,2,0,0,0,1,2,0,0,0,0,0,0,0
"kaggle:titanic","FUN",4,3,2,0,3,2,0,0,0,1,2,0,0,0,0,0,0,0
"kaggle:titanic","FUN",4,3,2,0,3,2,0,0,0,1,2,0,0,0,0,0,0,0
"kaggle:titanic","FUN",4,3,2,0,3,2,0,0,0,1,2,0,0,0,0,0,0,0
"kaggle:titanic","FUN",4,3,2,0,3,2,0,0,0,1,2,0,0,0,0,0,0,0
"kaggle:titanic","FUN",4,3,2,0,3,2,0,0,0,1,2,0,0,0,0,0,0,0
"kaggle:titanic","FUN",4,3,2,0,3,2,0,0,0,1,2,0,0,0,0,0,0,0
"kaggle:titanic","FUN",4,3,2,0,3,2,0,0,0,1,2,0,0,0,0,0,0,0
"kaggle:titanic","FUN",4,3,2,0,3,2,0,0,0,1,2,0,0,0,0,0,0,0
"kaggle:titanic","FUN",4,3,2,0,3,2,0,0,0,1,2,0,0,0,0,0,0,0
"kaggle:titanic","FUN",4,3,2,0,3,2,0,0,0,1,2,0,0,0,0,0,0,0
"kaggle:titanic","FUN",4,3,2,0,3,2,0,0,0,1,2,0,0,0,0,0,0,0
"kaggle:titanic","FUN",4,3,2,0,3,2,0,0,0,1,2,0,0,0,0,0,0,0
"kaggle:titanic","FUN",4,3,2,0,3,2,0,0,0,1,2,0,0,0,0,0,0,0
"kaggle:titanic","FUN",4,3,2,0,3,2,0,0,0,1,2,0,0,0,0,0,0,0
"kaggle:titanic","FUN",4,3,2,0,3,2,0,0,0,1,2,0,0,0,0,0,0,0
"kaggle:titanic","FUN",4,3,2,0,3,2,0,0,0,1,2,0,0,0,0,0,0,0
"kaggle:titanic","FUN",4,3,2,0,3,2,0,0,0,1,2,0,0,0,0,0,0,0
"kaggle:titanic","FUN",4,3,2,0,3,2,0,0,0,1,2,0,0,0,0,0,0,0
"kaggle:titanic","FUN",4,3,2,0,3,2,0,0,0,1,2,0,0,0,0,0,0,0
"kaggle:titanic","FUN",4,3,2,0,3,2,0,0,0,1,2,0,0,0,0,0,0,0
"kaggle:titanic","FUN",4,3,2,0,3,2,0,0,0,1,2,0,0,0,0,0,0,0
"kaggle:titanic","FUN",4,3,2,0,3,2,0,0,0,1,2,0,0,0,0,0,0,0
"kaggle:titanic","FUN",4,3,2,0,3,2,0,0,0,1,2,0,0,0,0,0,0,0
"kaggle:titanic","FUN",4,3,2,0,3,2,0,0,0,1,2,0,0,0,0,0,0,0
"kaggle:titanic","FUN",4,3,2,0,3,2,0,0,0,1,2,0,0,0,0,0,0,0
"kaggle:titanic","FUN",4,3,2,0,3,2,0,0,0,1,2,0,0,0,0,0,0,0
"kaggle:titanic","FUN",4,3,2,0,3,2,0,0,0,1,2,0,0,0,0,0,0,0
"kaggle:titanic","FUN",4,3,2,0,3,2,0,0,0,1,2,0,0,0,0,0,0,0
"kaggle:titanic","FUN",4,3,2,0,3,2,0,0,0,1,2,0,0,0,0,0,0,0
"kaggle:titanic","FUN",4,3,2,0,3,2,0,0,0,1,2,0,0,0,0,0,0,0
"kaggle:titanic","FUN",4,3,2,0,3,2,0,0,0,1,2,0,0,0,0,0,0,0
"kaggle:titanic","FUN",4,3,2,0,3,2,0,0,0,1,2,0,2,0,2,0,0,0
"kaggle:titanic","FUN",4,3,2,0,3,2,0,0,0,1,2,0,0,0,0,0,0,0
"kaggle:titanic","FUN",4,3,2,0,3,2,0,0,0,1,2,0,0,0,0,0,0,0
"kaggle:titanic","FUN",4,3,2,0,3,2,0,0,0,1,2,0,0,0,0,0,0,0
"kaggle:titanic","FUN",4,3,2,0,3,2,0,0,0,1,2,0,0,0,0,0,0,0
"kaggle:titanic","FUN",4,3,2,0,3,2,0,0,0,1,2,0,0,0,0,0,0,0
"kaggle:titanic","FUN",4,3,2,0,3,2,0,0,0,1,2,0,0,0,0,0,0,0
"kaggle:titanic","FUN",4,3,2,0,3,2,0,0,0,1,2,0,0,0,0,0,0,0
"kaggle:titanic","FUN",4,3,2,0,3,2,0,0,0,1,2,0,0,0,0,0,0,0
"kaggle:titanic","FUN",4,3,2,0,3,2,0,0,0,1,2,0,0,0,0,0,0,0
"kaggle:titanic","FUN",4,3,2,0,3,2,0,0,0,1,2,0,0,0,0,0,0,0
"kaggle:titanic","FUN",4,3,2,0,3,2,0,0,0,1,2,0,0,0,0,0,0,0
"kaggle:titanic","FUN",4,3,2,0,3,2,0,0,0,1,2,0,0,0,0,0,0,0
"kaggle:titanic","FUN",4,3,2,0,3,2,0,0,0,1,2,0,0,0,0,0,0,0
"kaggle:titanic","FUN",4,3,2,0,3,2,0,0,0,1,2,0,0,0,0,0,0,0
"kaggle:titanic","FUN",4,3,2,0,3,2,0,0,0,1,2,0,0,0,0,0,0,0
"kaggle:titanic","FUN",4,3,2,0,3,2,0,0,0,1,2,0,0,0,0,0,0,0
"kaggle:titanic","FUN",4,3,2,0,3,2,0,0,0,1,2,0,0,0,0,0,0,0
"kaggle:titanic","FUN",4,3,2,0,3,2,0,0,0,1,2,0,0,0,0,0,0,0
"kaggle:titanic","FUN",4,3,2,0,3,2,0,0,0,1,2,0,0,0,0,0,0,0
"kaggle:titanic","FUN",4,3,2,0,3,2,0,0,0,1,2,0,0,0,0,0,0,0
"kaggle:titanic","FUN",4,3,2,0,3,2,0,0,0,1,2,0,0,0,0,0,0,0
"kaggle:titanic","FUN",4,3,2,0,3,2,0,0,0,1,2,0,0,0,0,0,0,0
"kaggle:titanic","FUN",4,3,2,0,3,2,0,0,0,1,2,0,0,0,0,0,0,0
"kaggle:titanic","FUN",4,3,2,0,3,2,0,0,0,1,2,0,0,0,0,0,0,0
"kaggle:titanic","FUN",4,3,2,0,3,2,0,0,0,1,2,0,0,0,0,0,0,0
"kaggle:titanic","FUN",4,3,2,0,3,2,0,0,0,1,2,0,0,0,0,0,0,0
"kaggle:titanic","FUN",4,3,2,0,3,2,0,0,0,1,2,0,0,0,0,0,0,0
"kaggle:titanic","FUN",4,3,2,0,3,2,0,0,0,1,2,0,0,0,0,0,0,0
"kaggle:titanic","FUN",4,3,2,0,3,2,0,0,0,1,2,0,0,0,0,0,0,0
"kaggle:titanic","FUN",4,3,2,0,3,2,0,0,0,1,2,0,0,0,0,0,0,0
"kaggle:titanic","FUN",4,3,2,0,3,2,0,0,0,1,2,0,0,0,0,0,0,0
"kaggle:titanic","FUN",4,3,2,0,3,2,0,0,0,1,2,0,0,0,0,0,0,0
"kaggle:titanic","FUN",4,3,2,0,3,2,0,0,0,1,2,0,2,0,2,0,0,0
"kaggle:titanic","FUN",4,3,2,0,3,2,0,0,0,1,2,0,0,0,0,0,0,0
"kaggle:titanic","FUN",4,3,2,0,3,2,0,0,0,1,2,0,0,0,0,0,0,0
"kaggle:titanic","FUN",4,3,2,0,3,2,0,0,0,1,2,0,0,0,0,0,0,0
"kaggle:titanic","FUN",4,3,2,0,3,2,0,0,0,1,2,0,0,0,0,0,0,0
"kaggle:titanic","FUN",4,3,2,0,3,2,0,0,0,1,2,0,0,0,0,0,0,0
"kaggle:titanic","FUN",4,3,2,0,3,2,0,0,0,1,2,0,0,0,0,0,0,0
"kaggle:titanic","FUN",4,3,2,0,3,2,0,0,0,1,2,0,0,0,0,0,0,0
"kaggle:titanic","FUN",4,3,2,0,3,2,0,0,0,1,2,0,0,0,0,0,0,0
"kaggle:titanic","FUN",4,3,2,0,3,2,0,0,0,1,2,0,0,0,0,0,0,0
"kaggle:titanic","FUN",4,3,2,0,3,2,0,0,0,1,2,0,0,0,0,0,0,0
"kaggle:titanic","FUN",4,3,2,0,3,2,0,0,0,1,2,0,0,0,0,0,0,0
"kaggle:titanic","FUN",4,3,2,0,3,2,0,0,0,1,2,0,0,0,0,0,0,0
"kaggle:titanic","FUN",4,3,2,0,3,2,0,0,0,1,2,0,0,0,0,0,0,0
"kaggle:titanic","FUN",4,3,2,0,3,2,0,0,0,1,2,0,0,0,0,0,0,0
"kaggle:titanic","FUN",4,3,2,0,3,2,0,0,0,1,2,0,0,0,0,0,0,0
"kaggle:titanic","FUN",4,3,2,0,3,2,0,0,0,1,2,0,0,0,0,0,0,0
"kaggle:titanic","FUN",4,3,2,0,3,2,0,0,0,1,2,0,0,0,0,0,0,0
"kaggle:titanic","FUN",4,3,2,0,3,2,0,0,0,1,2,0,0,0,0,0,0,0
"kaggle:titanic","FUN",4,3,2,0,3,2,0,0,0,1,2,0,2,0,2,0,0,0
"kaggle:titanic","FUN",4,3,2,0,3,2,0,0,0,1,2,0,0,0,0,0,0,0
"kaggle:titanic","FUN",4,3,2,0,3,2,0,0,0,1,2,0,0,0,0,0,0,0
"kaggle:titanic","FUN",4,3,2,0,3,2,0,0,0,1,2,0,0,0,0,0,0,0
"kaggle:titanic","FUN",4,3,2,0,3,2,0,0,0,1,2,0,0,0,0,0,0,0
"kaggle:titanic","FUN",4,3,2,0,3,2,0,0,0,1,2,0,0,0,0,0,0,0
"kaggle:titanic","FUN",4,3,2,0,3,2,0,0,0,1,2,0,0,0,0,0,0,0
"kaggle:titanic","FUN",4,3,2,0,3,2,0,0,0,1,2,0,0,0,0,0,0,0
"kaggle:titanic","FUN",4,3,2,0,3,2,0,0,0,1,2,0,0,0,0,0,0,0
"kaggle:titanic","FUN",4,3,2,0,3,2,0,0,0,1,2,0,0,0,0,0,0,0
"kaggle:titanic","FUN",4,3,2,0,3,2,0,0,0,1,2,0,0,0,0,0,0,0
"kaggle:titanic","FUN",4,3,2,0,3,2,0,0,0,1,2,0,0,0,0,0,0,0
"kaggle:titanic","FUN",4,3,2,0,3,2,0,0,0,1,2,0,0,0,0,0,0,0
"kaggle:titanic","FUN",4,3,2,0,3,2,0,0,0,1,2,0,0,0,0,0,0,0
"kaggle:titanic","inject",10,5,4,0,5,3,0,0,0,2,2,2,1,0,1,0,0,0
"kaggle:titanic","deparse",11,11,6,2,9,4,1,1,0,5,8,0,2,1,1,0,1,0
"kaggle:titanic","is_call",11,6,6,1,5,5,1,0,0,0,2,3,4,0,4,0,0,0
"kaggle:titanic","strip_dots",102,55,35,12,43,20,7,5,0,23,33,5,16,2,14,0,2,0
"kaggle:titanic","make_labels",9,9,3,0,9,3,0,0,0,6,5,2,7,0,7,0,0,0
"kaggle:titanic","strip_stage",43,21,16,4,17,12,3,1,0,5,10,6,11,0,11,0,0,0
"kaggle:titanic","expr_text",72,39,25,8,31,17,5,3,0,14,17,6,6,1,5,0,1,0
"kaggle:titanic","needs_backticks",53,40,25,14,26,12,10,4,0,14,18,6,12,4,8,1,3,0
"kaggle:titanic","quo_get_env",5,3,3,0,3,3,0,0,0,0,0,3,0,0,0,0,0,0
"kaggle:titanic","caller_env",3,3,1,0,3,1,0,0,0,2,2,1,0,0,0,0,0,0
"kaggle:titanic","chartr",9,5,5,1,4,4,0,1,0,0,3,1,0,0,0,0,0,0
"kaggle:titanic","is_call",11,6,6,1,5,5,1,0,0,0,2,3,4,0,4,0,0,0
"kaggle:titanic","strip_dots",102,55,35,12,43,20,7,5,0,23,33,5,16,2,14,0,2,0
"kaggle:titanic","",49,42,27,3,39,18,3,0,0,21,19,8,15,0,15,0,0,0
"kaggle:titanic","expr_text",72,39,25,8,31,17,5,3,0,14,17,6,6,1,5,0,1,0
"kaggle:titanic","needs_backticks",53,40,25,14,26,12,10,4,0,14,18,6,12,4,8,1,3,0
"kaggle:titanic","element_line",87,54,37,11,43,18,7,4,0,25,35,3,13,2,11,0,2,0
"kaggle:titanic","plot_clone",11,2,2,0,2,2,0,0,0,0,2,0,0,0,0,0,0,0
"kaggle:titanic","unknown--fromConstant",12,7,6,0,7,6,0,0,0,1,4,3,2,0,2,0,0,0
"kaggle:titanic","data_frame0",1,1,1,0,1,1,0,0,0,0,0,1,0,0,0,0,0,0
"kaggle:titanic","vec_size",7,4,4,1,3,3,1,0,0,0,0,3,1,0,1,0,0,0
"kaggle:titanic","set_names",13,7,7,1,6,6,0,1,0,0,3,3,3,1,2,0,1,0
"kaggle:titanic","vec_unique",4,4,1,0,4,1,0,0,0,3,3,0,3,0,3,0,0,0
"kaggle:titanic","vec_unique_loc",5,3,3,0,3,3,0,0,0,0,0,3,1,0,1,0,0,0
"kaggle:titanic","is_character",7,4,4,1,3,3,1,0,0,0,0,3,2,0,2,0,0,0
"kaggle:titanic","stdin",0,0,0,0,0,0,0,0,0,0,0,0,0,0,0,0,0,0
"kaggle:titanic","FUN",41,18,12,4,14,8,3,1,0,6,5,5,10,1,9,0,1,0
"kaggle:titanic","is_bare_list",13,9,7,2,7,4,2,0,0,3,5,1,1,0,1,0,0,0
"kaggle:titanic","scale_apply",50,35,24,8,27,15,5,3,0,12,17,7,6,2,4,0,2,0
"kaggle:titanic","FUN",91,71,35,14,57,17,6,8,0,40,52,2,4,0,4,0,0,0
"kaggle:titanic","exit_frame",144,74,46,17,57,22,15,2,0,35,50,4,5,1,4,1,0,0
"kaggle:titanic","setup_handlers",44,23,14,2,21,6,2,0,0,15,15,3,2,0,2,0,0,0
"kaggle:titanic","defer",64,35,15,1,34,13,0,1,0,21,28,4,2,0,2,0,0,0
"kaggle:titanic","cli__message",91,49,35,11,38,17,5,6,0,21,31,5,9,1,8,1,0,0
"kaggle:titanic","trim",17,9,7,4,5,3,4,0,0,2,4,0,0,0,0,0,0,0
"kaggle:titanic","",28,12,10,3,9,5,2,1,0,4,4,3,2,0,2,0,0,0
"kaggle:titanic","substring",38,23,20,12,11,9,4,8,0,2,9,2,11,8,3,0,8,0
"kaggle:titanic","glue",75,47,33,15,32,15,9,6,0,17,24,3,15,5,10,2,3,0
"kaggle:titanic",".transformer",111,77,43,17,60,18,10,7,0,42,52,4,13,4,9,1,3,0
"kaggle:titanic","regexpr",57,11,10,2,9,8,1,1,0,1,9,0,0,0,0,0,0,0
"kaggle:titanic","parse_plural",38,17,10,3,14,4,2,1,0,10,12,1,0,0,0,0,0,0
"kaggle:titanic","%??%",8,5,1,0,5,1,0,0,0,4,2,0,2,0,2,0,0,0
"kaggle:titanic","chain_error",15,12,7,1,11,4,0,1,0,7,9,0,3,0,3,0,0,0
"kaggle:titanic","process_plural",99,32,22,11,21,11,6,5,0,10,18,2,5,2,3,0,2,0
"kaggle:titanic","inline_regex",0,0,0,0,0,0,0,0,0,0,0,0,0,0,0,0,0,0
"kaggle:titanic","cli__message_create",20,8,6,1,7,5,1,0,0,2,5,1,0,0,0,0,0,0
"kaggle:titanic","get_handlers",3,2,2,0,2,2,0,0,0,0,0,2,2,0,2,0,0,0
"kaggle:titanic","make_ansi_style",96,62,32,13,49,10,5,8,0,39,45,1,13,0,13,0,0,0
"kaggle:titanic","ansi256",109,38,34,14,24,19,8,6,0,5,19,2,0,0,0,0,0,0
"kaggle:titanic","ansi_style_from_r_color",25,19,8,4,15,4,1,3,0,11,10,1,1,1,0,0,1,0
"kaggle:titanic","clii__container_start",287,134,72,23,111,40,19,4,0,71,98,7,34,3,31,0,3,0
"kaggle:titanic","merge_embedded_styles",112,66,37,16,50,19,12,4,0,31,47,1,28,1,27,0,1,0
"kaggle:titanic","trim",17,9,7,5,4,2,4,1,0,2,3,0,0,0,0,0,0,0
"kaggle:titanic","glue",58,38,20,9,29,8,5,4,0,21,22,2,15,5,10,2,3,0
"kaggle:titanic","sub",40,15,14,4,11,10,1,3,0,1,11,0,2,0,2,0,0,0
"kaggle:titanic","trimws",22,14,5,1,13,3,0,1,0,10,13,0,0,0,0,0,0,0
"kaggle:titanic","ansi_string",16,5,5,1,4,4,0,1,0,0,2,2,0,0,0,0,0,0
"kaggle:titanic","ansi_strip",33,17,6,1,16,5,0,1,0,11,15,0,0,0,0,0,0,0
"kaggle:titanic","peek_option",7,6,5,0,6,4,0,0,0,2,2,3,2,0,2,0,0,0
"kaggle:titanic","is_string",7,4,4,1,3,3,1,0,0,0,0,3,2,0,2,0,0,0
"kaggle:titanic","sort",8,5,4,2,3,0,2,0,0,3,2,0,0,0,0,0,0,0
"kaggle:titanic","id_var",35,19,14,5,14,7,5,0,0,7,12,2,8,0,8,0,0,0
"kaggle:titanic","formatC",259,124,80,36,88,36,22,14,0,52,85,1,5,1,4,1,0,0
"kaggle:titanic","storage.mode",4,4,4,1,3,1,1,0,0,2,2,0,1,0,1,0,0,0
"kaggle:titanic","expand_range4",64,47,31,16,31,14,15,1,0,17,29,2,4,1,3,1,0,0
"kaggle:titanic","expand_range4",64,47,31,16,31,14,15,1,0,17,29,2,4,1,3,1,0,0
"kaggle:titanic","expand_limits_continuous_trans",46,30,19,7,23,8,7,0,0,15,21,1,1,0,1,0,0,0
"kaggle:titanic","expansion",42,27,19,6,21,11,6,0,0,10,20,1,4,1,3,1,0,0
"kaggle:titanic","with_ordered_restart",2,2,1,0,2,1,0,0,0,1,2,0,0,0,0,0,0,0
"kaggle:titanic","",1,1,1,0,1,1,0,0,0,0,0,1,0,0,0,0,0,0
"kaggle:titanic","new.env",4,4,3,3,1,0,1,2,0,1,0,0,2,2,0,0,2,0
"kaggle:titanic","startsWith",2,2,2,1,1,1,0,1,0,0,0,1,0,0,0,0,0,0
"kaggle:titanic","has_flipped_aes",196,88,62,21,67,31,20,1,0,36,59,4,12,0,12,0,0,0
"kaggle:titanic","xor",17,7,5,5,2,0,5,0,0,2,2,0,0,0,0,0,0,0
"kaggle:titanic","cases",23,21,12,4,17,5,3,1,0,12,13,1,7,1,6,0,1,0
"kaggle:titanic","noNA.levels",22,6,6,3,3,3,1,2,0,0,1,2,5,2,3,0,2,0
"kaggle:titanic","apply",375,160,135,64,96,52,42,22,0,44,85,5,59,22,37,2,20,0
"kaggle:titanic","id_var",35,19,14,6,13,7,6,0,0,6,11,2,8,0,8,0,0,0
"kaggle:titanic","id",110,61,46,17,44,19,14,3,0,25,34,3,14,4,10,2,2,0
"kaggle:titanic","modify_list",16,14,13,7,7,6,0,7,0,1,6,1,6,1,5,0,1,0
"kaggle:titanic","apply_fun",65,40,21,7,33,11,5,2,0,22,30,2,4,1,3,1,0,0
"kaggle:titanic","FUN",23,7,4,1,6,2,1,0,0,4,5,0,0,0,0,0,0,0
"kaggle:titanic","%||%",3,3,2,0,3,2,0,0,0,1,3,0,3,0,3,0,0,0
"kaggle:titanic","expand_limits_scale",65,50,26,3,47,17,3,0,0,30,39,1,12,0,12,0,0,0
"kaggle:titanic","new.env",4,4,3,3,1,0,1,2,0,1,0,0,2,2,0,0,2,0
"kaggle:titanic","ggproto",65,25,18,6,19,9,4,2,0,10,14,2,8,3,5,1,2,0
"kaggle:titanic","censor",32,20,20,9,11,10,8,1,0,1,9,1,3,2,1,2,0,0
"kaggle:titanic","view_scale_primary",66,28,14,1,27,13,1,0,0,14,23,2,1,0,1,0,0,0
"kaggle:titanic","",25,17,11,3,14,6,2,1,0,8,11,3,0,0,0,0,0,0
"kaggle:titanic","unknown--fromOverride",487,136,115,58,78,43,42,16,0,35,75,1,24,12,12,0,12,0
"kaggle:titanic","",551,394,330,110,284,159,97,11,2,125,280,2,4,0,4,0,0,0
"kaggle:titanic","seq",1,0,0,0,0,0,0,0,0,0,0,0,0,0,0,0,0,0
"kaggle:titanic","",160,75,57,19,56,29,16,3,0,27,50,2,2,1,1,0,1,0
"kaggle:titanic","oob_squish",36,24,24,3,21,9,3,0,0,12,19,0,1,0,1,0,0,0
"kaggle:titanic","discard",31,13,13,2,11,7,2,0,0,4,10,0,1,0,1,0,0,0
"kaggle:titanic","",3,3,3,0,3,3,0,0,0,0,2,1,0,0,0,0,0,0
"kaggle:titanic","%|W|%",9,9,7,2,7,3,2,0,0,4,2,1,6,0,6,0,0,0
"kaggle:titanic","FUN",10,6,5,0,6,4,0,0,0,2,5,1,3,0,3,0,0,0
"kaggle:titanic","coord_munch",147,8,4,1,7,3,1,0,0,4,6,0,0,0,0,0,0,0
"kaggle:titanic","intersect",13,9,5,0,9,5,0,0,0,4,8,1,0,0,0,0,0,0
"kaggle:titanic","FUN",36,11,10,3,8,5,2,1,0,3,3,3,2,0,2,0,0,0
"kaggle:titanic","defer",68,40,29,8,32,12,7,1,0,20,24,4,5,1,4,1,0,0
"kaggle:titanic","split",1,0,0,0,0,0,0,0,0,0,0,0,0,0,0,0,0,0
"kaggle:titanic","make_proto_method",33,23,13,4,19,7,3,1,0,12,9,5,8,1,7,1,0,0
"kaggle:titanic","check_linewidth",17,3,2,0,3,2,0,0,0,1,2,1,1,0,1,0,0,0
"kaggle:titanic","break_positions_minor",10,8,5,0,8,4,0,0,0,4,8,0,0,0,0,0,0,0
"kaggle:titanic","get_breaks_minor",3,2,1,0,2,1,0,0,0,1,0,1,0,0,0,0,0,0
"kaggle:titanic","break_positions",8,6,2,0,6,2,0,0,0,4,4,1,2,0,2,0,0,0
"kaggle:titanic","panel_guides_grob",30,18,9,2,16,5,2,0,0,11,11,1,2,0,2,0,0,0
"kaggle:titanic","gtable_width",7,3,2,0,3,2,0,0,0,1,0,2,2,0,2,0,0,0
"kaggle:titanic","gtable_height",7,3,2,0,3,2,0,0,0,1,0,2,2,0,2,0,0,0
"kaggle:titanic","new_data_frame",22,16,11,3,13,6,2,1,0,7,8,2,3,1,2,0,1,0
"kaggle:titanic","add_theme",49,40,12,4,36,8,4,0,0,28,35,0,2,0,2,0,0,0
"kaggle:titanic","is_theme_validate",20,16,16,1,15,2,1,0,0,13,11,1,5,0,5,0,0,0
"kaggle:titanic","widthDetails",2,0,0,0,0,0,0,0,0,0,0,0,0,0,0,0,0,0
"kaggle:titanic","convertWidth",4,4,1,0,4,1,0,0,0,3,0,1,2,0,2,0,0,0
"kaggle:titanic","calc_element",99,51,25,5,46,16,4,1,0,30,39,3,13,1,12,0,1,0
"kaggle:titanic","element_render",22,12,5,0,12,4,0,0,0,8,10,1,0,0,0,0,0,0
"kaggle:titanic","FUN",29,25,12,6,19,4,6,0,0,15,5,3,9,0,9,0,0,0
"kaggle:titanic","FUN",64,48,21,9,39,9,3,6,0,30,29,4,6,0,6,0,0,0
"kaggle:titanic","setup_elements",19,17,6,3,14,3,1,2,0,11,10,0,0,0,0,0,0,0
"kaggle:titanic","is_theme_validate",20,16,16,1,15,2,1,0,0,13,11,1,5,0,5,0,0,0
"kaggle:titanic","width_cm",29,25,12,5,20,5,5,0,0,15,7,2,12,0,12,0,0,0
"kaggle:titanic","element_grob",1,0,0,0,0,0,0,0,0,0,0,0,0,0,0,0,0,0
"kaggle:titanic","gtable_add_rows",117,38,14,5,33,7,5,0,0,26,20,3,8,0,8,0,0,0
"kaggle:titanic","gtable_add_cols",117,38,14,4,34,8,4,0,0,26,20,4,9,0,9,0,0,0
"kaggle:titanic","",1,1,1,0,1,1,0,0,0,0,0,1,0,0,0,0,0,0
"kaggle:titanic","FUN",11,4,4,1,3,3,1,0,0,0,1,2,0,0,0,0,0,0
"kaggle:titanic","array",53,14,13,7,7,3,1,6,0,4,7,0,7,6,1,1,5,0
"kaggle:titanic","as.graphicsAnnot",10,5,5,1,4,1,1,0,0,3,4,0,3,1,2,1,0,0
"kaggle:titanic","rownames",28,16,15,6,10,6,4,2,0,4,4,3,7,2,5,0,2,0
"kaggle:titanic","reformulate",29,16,12,4,12,7,2,2,0,5,10,2,0,0,0,0,0,0
"kaggle:titanic","is.ordered",5,5,4,1,4,1,1,0,0,3,0,1,3,0,3,0,0,0
"kaggle:titanic","FUN",4,4,3,1,3,2,1,0,0,1,0,2,1,0,1,0,0,0
"kaggle:titanic","double",1,1,1,1,0,0,0,1,0,0,0,0,1,1,0,0,1,0
"kaggle:titanic","FUN",6,5,5,1,4,4,0,1,0,0,2,2,0,0,0,0,0,0
"kaggle:titanic","is_call",11,6,6,1,5,5,1,0,0,0,2,3,4,0,4,0,0,0
"kaggle:titanic","arg_match0",12,5,5,0,5,5,0,0,0,0,2,3,1,0,1,0,0,0
"kaggle:titanic","node_car",5,3,3,0,3,3,0,0,0,0,0,3,1,0,1,0,0,0
"kaggle:titanic","every",95,32,21,5,27,16,5,0,0,11,23,3,9,0,9,0,0,0
"kaggle:titanic","quo_is_symbolic",5,3,3,1,2,2,1,0,0,0,0,2,0,0,0,0,0,0
"kaggle:titanic","fortify",1,0,0,0,0,0,0,0,0,0,0,0,0,0,0,0,0,0
"kaggle:titanic","is_scalar_character",9,6,5,2,4,3,2,0,0,1,0,3,2,0,2,0,0,0
"kaggle:titanic","unknown--fromConstant",40,13,12,3,10,9,1,2,0,1,10,0,3,0,3,0,0,0
"kaggle:titanic","camelize",15,15,6,0,15,6,0,0,0,9,11,2,1,0,1,0,0,0
"kaggle:titanic","to_upper_ascii",13,9,6,0,9,6,0,0,0,3,8,1,0,0,0,0,0,0
"kaggle:titanic","substring",38,23,23,11,12,10,4,7,0,2,10,2,11,7,4,0,7,0
"kaggle:titanic","FUN",38,29,19,8,21,9,8,0,0,12,6,8,13,1,12,1,0,0
"kaggle:titanic","FUN",1,0,0,0,0,0,0,0,0,0,0,0,0,0,0,0,0,0
"kaggle:titanic","check_breaks_labels",20,5,5,1,4,2,1,0,0,2,3,1,1,0,1,0,0,0
"kaggle:titanic","get_inherit",3,3,2,0,3,2,0,0,0,1,0,2,0,0,0,0,0,0
"kaggle:titanic","paste",4,4,4,4,0,0,1,3,0,0,0,0,2,2,0,0,2,0
"kaggle:titanic","scale_type",1,0,0,0,0,0,0,0,0,0,0,0,0,0,0,0,0,0
"kaggle:titanic","find_scale",52,27,21,4,23,13,4,0,0,10,15,5,8,0,8,0,0,0
"kaggle:titanic","find_global",17,8,2,1,7,1,1,0,0,6,6,1,1,0,1,0,0,0
"kaggle:titanic","current_call",29,16,4,1,15,3,1,0,0,12,10,2,1,0,1,0,0,0
"kaggle:titanic","new_continuous_palette",32,12,9,2,10,7,2,0,0,3,3,4,1,0,1,0,0,0
"kaggle:titanic","vapply",17,11,9,0,11,8,0,0,0,3,6,3,7,0,7,0,0,0
"kaggle:titanic","check_nondata_cols",23,11,8,3,8,5,2,1,0,3,4,2,2,0,2,0,0,0
"kaggle:titanic","scale_type",1,0,0,0,0,0,0,0,0,0,0,0,0,0,0,0,0,0
"kaggle:titanic","FUN",14,8,7,3,5,3,2,1,0,2,3,2,3,0,3,0,0,0
"kaggle:titanic","scale_apply",50,35,24,7,28,16,5,2,0,12,18,7,6,1,5,0,1,0
"kaggle:titanic","as_label",113,67,45,8,59,27,8,0,0,32,37,10,23,0,23,0,0,0
"kaggle:titanic","strip_dots",106,59,36,12,47,21,7,5,0,26,35,5,17,2,15,0,2,0
"kaggle:titanic","rep_len",2,2,2,2,0,0,0,2,0,0,0,0,2,2,0,0,2,0
"kaggle:titanic","new_mapped_discrete",8,4,1,0,4,1,0,0,0,3,3,1,0,0,0,0,0,0
"kaggle:titanic","vec_slice",10,5,5,0,5,4,0,0,0,1,2,3,2,0,2,0,0,0
"kaggle:titanic","eval_bare",8,5,4,0,5,3,0,0,0,2,2,2,1,0,1,0,0,0
"kaggle:titanic","slot<-",14,6,6,0,6,6,0,0,0,0,2,4,1,0,1,0,0,0
"kaggle:titanic",".simpleInheritanceGeneric",13,11,9,1,10,1,1,0,0,9,8,0,4,0,4,0,0,0
"kaggle:titanic","is_discrete",0,0,0,0,0,0,0,0,0,0,0,0,0,0,0,0,0,0
"kaggle:titanic","is_empty",13,3,1,0,3,1,0,0,0,2,2,1,0,0,0,0,0,0
"kaggle:titanic","view_scale_secondary",156,45,22,3,42,17,3,0,0,25,29,4,6,0,6,0,0,0
"kaggle:titanic","expand_limits_discrete_trans",155,71,33,19,52,21,18,1,0,31,48,3,2,0,2,0,0,0
"kaggle:titanic","expand_limits_discrete",10,7,2,0,7,2,0,0,0,5,6,0,0,0,0,0,0,0
"kaggle:titanic","expand_limits_scale",64,49,22,3,46,17,3,0,0,29,39,1,11,0,11,0,0,0
"kaggle:titanic","view_scale_primary",66,28,14,1,27,13,1,0,0,14,23,2,1,0,1,0,0,0
"kaggle:titanic","view_scales_from_scale",76,56,25,8,48,15,4,4,0,33,35,3,11,0,11,0,0,0
"kaggle:titanic","force",1,1,1,0,1,1,0,0,0,0,0,1,1,0,1,0,0,0
"kaggle:titanic",".doSortWrap",40,22,21,8,14,10,6,2,0,4,10,2,8,2,6,1,1,0
"kaggle:titanic","",12,12,8,2,10,4,2,0,0,6,4,1,6,0,6,0,0,0
"kaggle:titanic","",16,15,8,2,13,4,2,0,0,9,5,1,6,0,6,0,0,0
"kaggle:titanic","is_discrete",3,2,1,1,1,0,1,0,0,1,0,0,0,0,0,0,0,0
"kaggle:titanic","extract_params",11,1,1,0,1,1,0,0,0,0,0,1,0,0,0,0,0,0
"kaggle:titanic","",20,16,7,0,16,6,0,0,0,10,16,0,0,0,0,0,0,0
"kaggle:titanic","get_layer_key",1,1,1,0,1,1,0,0,0,0,0,1,0,0,0,0,0,0
"kaggle:titanic","oob_censor_any",35,20,16,3,17,10,3,0,0,7,17,0,0,0,0,0,0,0
"kaggle:titanic","make_title",1,1,1,1,0,0,0,1,0,0,0,0,0,0,0,0,0,0
"kaggle:titanic","rescale",1,0,0,0,0,0,0,0,0,0,0,0,0,0,0,0,0,0
"kaggle:titanic","l_interp",28,19,11,0,19,11,0,0,0,8,14,3,0,0,0,0,0,0
"kaggle:titanic","ggproto_parent",59,30,23,8,22,14,4,4,0,8,19,2,6,2,4,0,2,0
"kaggle:titanic","vec_any_missing",5,3,3,1,2,2,1,0,0,0,0,2,0,0,0,0,0,0
"kaggle:titanic","vec_interleave_indices",7,4,4,0,4,4,0,0,0,0,2,2,0,0,0,0,0,0
"kaggle:titanic","draw_axis_labels",36,14,11,2,12,9,2,0,0,3,7,4,3,0,3,0,0,0
"kaggle:titanic","setup_params",62,42,29,14,28,12,5,9,0,16,26,1,4,1,3,1,0,0
"kaggle:titanic","setup_elements",33,28,11,3,25,6,1,2,0,19,19,2,3,0,3,0,0,0
"kaggle:titanic","element_text",118,60,43,23,37,17,12,11,0,20,31,2,24,9,15,0,9,0
"kaggle:titanic","override_elements",142,17,11,3,14,6,3,0,0,8,10,1,3,0,3,0,0,0
"kaggle:titanic","build_title",2,2,2,0,2,1,0,0,0,1,0,1,0,0,0,0,0,0
"kaggle:titanic","build_ticks",48,20,4,1,19,3,1,0,0,16,15,1,0,0,0,0,0,0
"kaggle:titanic","is_theme_element",18,16,11,4,12,3,4,0,0,9,8,1,5,0,5,0,0,0
"kaggle:titanic","element_grob",1,0,0,0,0,0,0,0,0,0,0,0,0,0,0,0,0,0
"kaggle:titanic","build_ticks",120,70,43,8,62,31,8,0,0,31,47,6,15,1,14,1,0,0
"kaggle:titanic","build_labels",80,43,29,6,37,17,5,1,0,20,25,6,14,1,13,1,0,0
"kaggle:titanic","FUN",19,15,1,0,15,1,0,0,0,14,15,0,2,0,2,0,0,0
"kaggle:titanic","structure",55,26,21,8,18,13,4,4,0,5,17,1,6,2,4,0,2,0
"kaggle:titanic","convertUnit",49,46,23,8,38,15,8,0,0,23,34,2,6,1,5,1,0,0
"kaggle:titanic","measure_grobs",121,79,43,4,75,38,4,0,0,37,62,9,6,0,6,0,0,0
"kaggle:titanic","arrange_layout",27,21,17,4,17,11,4,0,0,6,15,2,0,0,0,0,0,0
"kaggle:titanic","assemble_drawing",138,68,27,3,65,24,1,2,0,41,56,8,16,0,16,0,0,0
"kaggle:titanic","setNames",4,3,3,0,3,3,0,0,0,0,2,1,0,0,0,0,0,0
"kaggle:titanic","grobHeight",1,0,0,0,0,0,0,0,0,0,0,0,0,0,0,0,0,0
"kaggle:titanic","ifelse",105,59,57,25,34,24,14,11,0,10,28,4,29,16,13,8,8,0
"kaggle:titanic","unitType",68,21,16,5,16,9,2,3,0,7,11,2,5,2,3,0,2,0
"kaggle:titanic","validate_labels",16,2,2,1,1,0,0,1,0,1,1,0,0,0,0,0,0,0
"kaggle:titanic","%||%",3,3,3,0,3,2,0,0,0,1,3,0,3,0,3,0,0,0
"kaggle:titanic","apply",375,193,156,74,119,59,47,27,0,60,108,4,61,22,39,2,20,0
"kaggle:titanic","array",53,14,9,6,8,1,1,5,0,7,8,0,7,5,2,1,4,0
"kaggle:titanic","gtable_add_rows",117,38,14,5,33,7,5,0,0,26,20,3,8,0,8,0,0,0
"kaggle:titanic","gtable_add_rows",117,38,14,5,33,7,5,0,0,26,20,3,8,0,8,0,0,0
"kaggle:titanic","gtable_add_cols",117,38,14,4,34,8,4,0,0,26,20,4,9,0,9,0,0,0
"kaggle:titanic","gtable_add_padding",19,18,6,0,18,5,0,0,0,13,18,0,0,0,0,0,0,0
"kaggle:titanic","package_box",368,159,76,12,147,13,7,5,0,134,132,3,11,0,11,0,0,0
"kaggle:titanic","FUN",9,7,5,2,5,1,2,0,0,4,0,1,2,0,2,0,0,0
"kaggle:titanic","FUN",11,7,7,4,3,3,3,1,0,0,3,0,3,1,2,0,1,0
"kaggle:titanic","FUN",14,10,7,4,6,1,4,0,0,5,2,1,5,0,5,0,0,0
"kaggle:titanic","FUN",14,12,9,5,7,2,4,1,0,5,2,1,4,0,4,0,0,0
"kaggle:titanic","matrix",13,11,7,0,11,3,0,0,0,8,8,2,6,0,6,0,0,0
"RealThing:volcano","match",4,4,4,2,2,1,0,2,0,1,0,1,2,2,0,0,2,0
"RealThing:volcano","%in%",8,8,8,2,6,3,1,1,0,3,0,3,4,1,3,0,1,0
"RealThing:volcano","unknown--fromConstant",4,3,3,2,1,1,2,0,0,0,0,1,0,0,0,0,0,0
"RealThing:volcano","unknown--fromConstant",4,3,3,2,1,1,2,0,0,0,0,1,0,0,0,0,0,0
"RealThing:volcano","bilinear",105,85,85,10,75,24,9,1,0,51,72,1,0,0,0,0,0,0
"RealThing:volcano","match.fun",40,3,3,1,2,1,0,1,0,1,1,1,0,0,0,0,0,0
"RealThing:volcano","is.logint",9,4,4,0,4,1,0,0,0,3,4,0,0,0,0,0,0,0
"RealThing:volcano","lapply",17,13,8,0,13,7,0,0,0,6,10,0,7,0,7,0,0,0
"RealThing:volcano","isFALSE",11,8,7,1,7,1,1,0,0,6,6,0,0,0,0,0,0,0
"RealThing:volcano","unlist",27,5,5,0,5,5,0,0,0,0,5,0,0,0,0,0,0,0
"RealThing:volcano","unknown--fromConstant",4,3,3,1,2,2,1,0,0,0,0,2,0,0,0,0,0,0
"RealThing:volcano","bench_rays",1448,212,190,67,145,58,63,4,0,87,141,2,4,0,4,0,0,0
"RealThing:volcano","sapply",32,20,15,4,16,8,4,0,0,8,15,0,0,0,0,0,0,0
"RealThing:volcano","bilinear",105,85,85,12,73,22,11,1,0,51,70,1,0,0,0,0,0,0
"RealThing:volcano","unknown--fromConstant",2,2,2,1,1,1,0,1,0,0,0,1,0,0,0,0,0,0
"RealThing:volcano","unique",1,0,0,0,0,0,0,0,0,0,0,0,0,0,0,0,0,0
"RealThing:volcano","simplify2array",151,23,20,8,15,8,7,1,0,7,14,1,0,0,0,0,0,0
"RealThing:volcano","chkDots",15,1,1,1,0,0,1,0,0,0,0,0,0,0,0,0,0,0
"RealThing:volcano","as.vector",2,2,2,1,1,0,1,0,0,1,0,0,0,0,0,0,0,0
"RealThing:volcano","Sys.time",8,5,4,0,5,4,0,0,0,1,2,2,0,0,0,0,0,0
"RealThing:volcano","execute",39,18,13,4,14,7,4,0,0,7,14,0,0,0,0,0,0,0
"RealThing:volcano","print",1,0,0,0,0,0,0,0,0,0,0,0,0,0,0,0,0,0
"RealThing:volcano","stdout",0,0,0,0,0,0,0,0,0,0,0,0,0,0,0,0,0,0
