benchmark,closure,referenced,referenced non-empty,read non-empty,used,unused non-empty,present non-empty,exact match,widened,narrowed,optimized away non-empty,dependent,other reasons unused non-empty,polluted,used polluted,unused polluted,used polluted exact match,used polluted widened,used polluted narrowed
"areWeFast:Bounce_nonames_simple","match",4,4,4,1,3,1,0,1,0,2,0,1,2,1,1,0,1,0
"areWeFast:Bounce_nonames_simple","nextRandom",7,7,6,3,4,2,2,1,0,2,4,0,1,1,0,0,1,0
"areWeFast:Bounce_nonames_simple","FUN",8,8,8,4,4,3,2,2,0,1,4,0,0,0,0,0,0,0
"areWeFast:Bounce_nonames_simple","bounce",63,46,28,1,45,27,1,0,0,18,44,1,0,0,0,0,0,0
"areWeFast:Bounce_nonames_simple","lapply",17,13,12,0,13,11,0,0,0,2,10,1,4,0,4,0,0,0
"areWeFast:Bounce_nonames_simple","match.fun",40,3,3,1,2,1,0,1,0,1,1,1,2,1,1,0,1,0
"areWeFast:Bounce_nonames_simple","vector",2,2,2,0,2,2,0,0,0,0,0,2,1,0,1,0,0,0
"areWeFast:Bounce_nonames_simple","verifyResult",2,2,2,1,1,1,1,0,0,0,0,1,0,0,0,0,0,0
"areWeFast:Bounce_nonames_simple","execute",113,70,60,1,69,37,1,0,0,32,63,2,6,0,6,0,0,0
"areWeFast:Bounce_nonames_simple","Sys.time",8,5,5,0,5,5,0,0,0,0,2,3,0,0,0,0,0,0
"areWeFast:Bounce_nonames_simple","stdout",0,0,0,0,0,0,0,0,0,0,0,0,0,0,0,0,0,0
"shootout:binarytrees/binarytrees_naive","match",4,4,4,2,2,1,0,2,0,1,0,1,2,2,0,0,2,0
"shootout:binarytrees/binarytrees_naive","%in%",8,8,8,2,6,3,1,1,0,3,0,3,4,1,3,0,1,0
"shootout:binarytrees/binarytrees_naive","tree",30,8,8,1,7,7,1,0,0,0,6,1,0,0,0,0,0,0
"shootout:binarytrees/binarytrees_naive","tree",30,17,17,3,14,14,3,0,0,0,12,2,2,0,2,0,0,0
"shootout:binarytrees/binarytrees_naive","check",19,8,8,5,3,3,2,3,0,0,2,1,0,0,0,0,0,0
"shootout:binarytrees/binarytrees_naive","check",19,16,16,8,8,8,5,3,0,0,7,1,4,2,2,0,2,0
"shootout:binarytrees/binarytrees_naive","tree",30,17,17,0,17,16,0,0,0,1,14,2,2,0,2,0,0,0
"shootout:binarytrees/binarytrees_naive","tree",30,17,17,2,15,15,1,1,0,0,12,3,10,1,9,0,1,0
"shootout:binarytrees/binarytrees_naive","check",19,16,16,9,7,7,3,6,0,0,7,0,12,7,5,2,5,0
"shootout:binarytrees/binarytrees_naive","stdout",0,0,0,0,0,0,0,0,0,0,0,0,0,0,0,0,0,0
"shootout:binarytrees/binarytrees_naive","tree",30,17,17,0,17,17,0,0,0,0,14,3,10,0,10,0,0,0
"shootout:binarytrees/binarytrees_naive","Sys.time",8,5,5,0,5,5,0,0,0,0,2,3,0,0,0,0,0,0
"shootout:binarytrees/binarytrees_naive","is.logint",9,4,4,0,4,1,0,0,0,3,4,0,0,0,0,0,0,0
"shootout:binarytrees/binarytrees_naive","FUN",6,4,2,0,4,0,0,0,0,4,4,0,0,0,0,0,0,0
"shootout:binarytrees/binarytrees_naive","match.fun",40,3,3,1,2,1,0,1,0,1,1,1,2,1,1,0,1,0
"shootout:binarytrees/binarytrees_naive","binarytrees_naive",159,104,81,20,84,63,13,7,0,21,76,6,24,7,17,2,5,0
"shootout:binarytrees/binarytrees_naive","execute",2,2,2,0,2,2,0,0,0,0,0,2,0,0,0,0,0,0
"shootout:binarytrees/binarytrees_naive","unknown--fromOverride",487,76,76,28,48,35,25,3,0,13,46,2,0,0,0,0,0,0
"shootout:binarytrees/binarytrees_naive","is.vector",2,2,1,0,2,1,0,0,0,1,0,1,0,0,0,0,0,0
"shootout:binarytrees/binarytrees_naive","chkDots",15,1,1,1,0,0,1,0,0,0,0,0,0,0,0,0,0,0
"shootout:binarytrees/binarytrees_naive","vapply",17,9,8,0,9,7,0,0,0,2,6,1,0,0,0,0,0,0
"shootout:binarytrees/binarytrees_naive","mostattributes<-",106,3,3,1,2,2,1,0,0,0,0,2,0,0,0,0,0,0
"shootout:knucleotide/knucleotide","match",4,4,4,2,2,1,0,2,0,1,0,1,2,2,0,0,2,0
"shootout:knucleotide/knucleotide","%in%",8,8,8,2,6,3,1,1,0,3,0,3,4,1,3,0,1,0
"shootout:knucleotide/knucleotide",".deparseOpts",83,30,22,10,20,12,8,2,0,8,14,4,2,0,2,0,0,0
"shootout:knucleotide/knucleotide","mode",27,21,21,4,17,15,1,3,0,2,15,2,2,1,1,0,1,0
"shootout:knucleotide/knucleotide","substr",13,7,7,2,5,3,2,0,0,2,4,1,0,0,0,0,0,0
"shootout:knucleotide/knucleotide","inherits",3,3,3,0,3,2,0,0,0,1,0,2,1,0,1,0,0,0
"shootout:knucleotide/knucleotide","identical",8,8,8,0,8,2,0,0,0,6,8,0,0,0,0,0,0,0
"shootout:knucleotide/knucleotide","assign",6,6,6,0,6,6,0,0,0,0,3,3,0,0,0,0,0,0
"shootout:knucleotide/knucleotide","FUN",3,3,3,1,2,2,1,0,0,0,0,2,0,0,0,0,0,0
"shootout:knucleotide/knucleotide","get",6,6,6,1,5,5,0,1,0,0,4,1,0,0,0,0,0,0
"shootout:knucleotide/knucleotide","match.fun",40,3,3,1,2,1,0,1,0,1,1,1,2,1,1,0,1,0
"shootout:knucleotide/knucleotide","is.vector",2,2,1,1,1,0,0,1,0,1,0,0,1,1,0,0,1,0
"shootout:knucleotide/knucleotide","lapply",17,13,12,0,13,11,0,0,0,2,8,3,8,0,8,0,0,0
"shootout:knucleotide/knucleotide","isFALSE",11,8,7,1,7,1,1,0,0,6,6,0,0,0,0,0,0,0
"shootout:knucleotide/knucleotide","unlist",27,5,5,0,5,5,0,0,0,0,5,0,2,0,2,0,0,0
"shootout:knucleotide/knucleotide","eval",8,6,6,1,5,5,0,1,0,0,5,0,1,1,0,0,1,0
"shootout:knucleotide/knucleotide","stdout",0,0,0,0,0,0,0,0,0,0,0,0,0,0,0,0,0,0
"shootout:knucleotide/knucleotide","exists",8,6,6,1,5,5,0,1,0,0,4,1,0,0,0,0,0,0
"shootout:knucleotide/knucleotide","assign",6,6,6,1,5,5,0,1,0,0,3,2,0,0,0,0,0,0
"shootout:knucleotide/knucleotide","gen_freq",95,54,52,9,45,39,7,2,0,6,38,2,5,0,5,0,0,0
"shootout:knucleotide/knucleotide","sapply",32,24,23,6,18,14,4,2,0,4,14,3,0,0,0,0,0,0
"shootout:knucleotide/knucleotide","parent.frame",1,1,1,0,1,0,0,0,0,1,0,0,0,0,0,0,0,0
"shootout:knucleotide/knucleotide","environment",1,1,1,0,1,0,0,0,0,1,0,0,0,0,0,0,0,0
"shootout:knucleotide/knucleotide","ls",48,13,11,2,11,8,1,1,0,3,7,1,1,0,1,0,0,0
"shootout:knucleotide/knucleotide","tryCatch",53,26,26,7,19,16,3,4,0,3,16,3,0,0,0,0,0,0
"shootout:knucleotide/knucleotide","environment",1,1,1,0,1,0,0,0,0,1,0,0,0,0,0,0,0,0
"shootout:knucleotide/knucleotide","tryCatchOne",30,4,4,0,4,4,0,0,0,0,2,2,0,0,0,0,0,0
"shootout:knucleotide/knucleotide","environment",1,1,1,0,1,0,0,0,0,1,0,0,0,0,0,0,0,0
"shootout:knucleotide/knucleotide","doTryCatch",7,6,6,0,6,5,0,0,0,1,3,3,0,0,0,0,0,0
"shootout:knucleotide/knucleotide","simplify2array",151,23,22,8,15,10,7,1,0,5,15,0,2,0,2,0,0,0
"shootout:knucleotide/knucleotide","unique",1,0,0,0,0,0,0,0,0,0,0,0,0,0,0,0,0,0
"shootout:knucleotide/knucleotide","unknown--fromConstant",2,2,2,1,1,1,0,1,0,0,0,1,0,0,0,0,0,0
"shootout:knucleotide/knucleotide","tolower",7,3,3,0,3,3,0,0,0,0,2,1,0,0,0,0,0,0
"shootout:knucleotide/knucleotide","%in%",8,8,8,3,5,3,1,2,0,2,0,3,4,2,2,0,2,0
"shootout:knucleotide/knucleotide","find_seq",20,19,19,5,14,11,2,3,0,3,8,3,4,2,2,0,2,0
"shootout:knucleotide/knucleotide","gen_freq",95,54,49,9,45,39,7,2,0,6,38,2,5,0,5,0,0,0
"shootout:knucleotide/knucleotide","nchar",4,4,4,1,3,0,0,1,0,3,3,0,0,0,0,0,0,0
"shootout:knucleotide/knucleotide","getOption",5,4,4,0,4,3,0,0,0,1,3,1,0,0,0,0,0,0
"shootout:knucleotide/knucleotide","vapply",17,9,8,0,9,7,0,0,0,2,6,1,3,0,3,0,0,0
"shootout:knucleotide/knucleotide","logical",1,1,1,0,1,1,0,0,0,0,0,1,0,0,0,0,0,0
"shootout:knucleotide/knucleotide","FUN",19,14,14,5,9,6,4,1,0,3,4,3,3,0,3,0,0,0
"shootout:knucleotide/knucleotide","sort_seq",48,31,24,1,30,20,1,0,0,10,25,3,2,0,2,0,0,0
"shootout:knucleotide/knucleotide","gen_freq",95,54,49,8,46,39,6,2,0,7,39,2,5,0,5,0,0,0
"shootout:knucleotide/knucleotide","formals",10,3,3,1,2,2,0,1,0,0,1,1,0,0,0,0,0,0
"shootout:knucleotide/knucleotide","match.arg",69,27,27,3,24,18,2,1,0,6,20,4,2,0,2,0,0,0
"shootout:knucleotide/knucleotide","sys.function",1,1,1,1,0,0,1,0,0,0,0,0,0,0,0,0,0,0
"shootout:knucleotide/knucleotide","sys.parent",1,1,1,0,1,0,0,0,0,1,0,0,0,0,0,0,0,0
"shootout:knucleotide/knucleotide","sys.frame",1,1,1,0,1,1,0,0,0,0,0,1,0,0,0,0,0,0
"shootout:knucleotide/knucleotide","Sys.time",8,5,5,0,5,5,0,0,0,0,2,3,0,0,0,0,0,0
"shootout:knucleotide/knucleotide","file",8,8,8,0,8,7,0,0,0,1,8,0,0,0,0,0,0,0
"shootout:knucleotide/knucleotide","close",1,0,0,0,0,0,0,0,0,0,0,0,0,0,0,0,0,0
"shootout:knucleotide/knucleotide","strsplit",7,6,3,2,4,1,0,2,0,3,4,0,0,0,0,0,0,0
"shootout:knucleotide/knucleotide","execute",8,8,5,0,8,5,0,0,0,3,2,3,1,0,1,0,0,0
"shootout:knucleotide/knucleotide","close",1,0,0,0,0,0,0,0,0,0,0,0,0,0,0,0,0,0
"shootout:knucleotide/knucleotide","knucleotide",195,153,141,37,116,82,21,16,0,34,107,7,3,1,2,0,1,0
"shootout:knucleotide/knucleotide","scan",55,30,30,2,28,26,1,1,0,2,24,2,1,0,1,0,0,0
"shootout:knucleotide/knucleotide","gen_freq",95,54,52,9,45,39,7,2,0,6,38,2,5,0,5,0,0,0
"shootout:knucleotide/knucleotide","get",6,6,6,0,6,6,0,0,0,0,5,1,0,0,0,0,0,0
"shootout:knucleotide/knucleotide","getOption",5,4,4,0,4,3,0,0,0,1,3,1,0,0,0,0,0,0
"shootout:fasta/fasta_naive_2","match",4,4,4,2,2,1,0,2,0,1,0,1,2,2,0,0,2,0
"shootout:fasta/fasta_naive_2","%in%",8,8,8,2,6,3,1,1,0,3,0,3,4,1,3,0,1,0
"shootout:fasta/fasta_naive_2",".deparseOpts",83,30,22,10,20,12,8,2,0,8,14,4,2,0,2,0,0,0
"shootout:fasta/fasta_naive_2","mode",27,21,21,4,17,15,1,3,0,2,15,2,2,1,1,0,1,0
"shootout:fasta/fasta_naive_2","withVisible",3,1,1,0,1,1,0,0,0,0,0,1,0,0,0,0,0,0
"shootout:fasta/fasta_naive_2","eval",8,6,6,0,6,6,0,0,0,0,5,1,0,0,0,0,0,0
"shootout:fasta/fasta_naive_2",".deparseOpts",83,30,22,10,20,12,8,2,0,8,14,4,2,0,2,0,0,0
"shootout:fasta/fasta_naive_2","deparse",11,11,11,2,9,9,1,1,0,0,8,1,0,0,0,0,0,0
"shootout:fasta/fasta_naive_2","stdout",0,0,0,0,0,0,0,0,0,0,0,0,0,0,0,0,0,0
"shootout:fasta/fasta_naive_2","myrandom",8,8,8,1,7,6,1,0,0,1,7,0,0,0,0,0,0,0
"shootout:fasta/fasta_naive_2","character",1,1,1,0,1,1,0,0,0,0,0,1,0,0,0,0,0,0
"shootout:fasta/fasta_naive_2","random_fasta",144,78,73,16,62,33,9,7,0,29,58,2,7,1,6,0,1,0
"shootout:fasta/fasta_naive_2","Sys.time",8,5,5,0,5,5,0,0,0,0,2,3,0,0,0,0,0,0
"shootout:fasta/fasta_naive_2","strsplit",7,6,3,2,4,1,0,2,0,3,4,0,0,0,0,0,0,0
"shootout:fasta/fasta_naive_2","fasta_naive_2",43,26,14,2,24,12,1,1,0,12,18,3,2,0,2,0,0,0
"shootout:fasta/fasta_naive_2","execute",2,2,2,0,2,2,0,0,0,0,0,2,0,0,0,0,0,0
"shootout:fasta/fasta_naive_2","repeat_fasta",158,106,98,22,84,42,14,8,0,42,80,2,2,0,2,0,0,0
"shootout:fannkuch/fannkuchredux","match",4,4,4,1,3,1,0,1,0,2,0,1,2,1,1,0,1,0
"shootout:fannkuch/fannkuchredux","rev.default",13,7,7,2,5,2,2,0,0,3,5,0,0,0,0,0,0,0
"shootout:fannkuch/fannkuchredux","stdout",0,0,0,0,0,0,0,0,0,0,0,0,0,0,0,0,0,0
"shootout:fannkuch/fannkuchredux","Sys.time",8,5,5,0,5,5,0,0,0,0,2,3,0,0,0,0,0,0
"shootout:fannkuch/fannkuchredux","execute",39,22,13,0,22,7,0,0,0,15,16,3,2,0,2,0,0,0
"shootout:fannkuch/fannkuchredux","fannkuch",187,146,138,2,144,55,2,0,0,89,140,2,2,0,2,0,0,0
"shootout:pidigits/pidigits","match",4,4,4,2,2,1,0,2,0,1,0,1,2,2,0,0,2,0
"shootout:pidigits/pidigits","%in%",8,8,8,2,6,3,1,1,0,3,0,3,4,1,3,0,1,0
"shootout:pidigits/pidigits",".deparseOpts",83,30,22,10,20,12,8,2,0,8,14,4,2,0,2,0,0,0
"shootout:pidigits/pidigits","mode",27,21,21,4,17,15,1,3,0,2,15,2,2,1,1,0,1,0
"shootout:pidigits/pidigits","withVisible",3,1,1,0,1,1,0,0,0,0,0,1,0,0,0,0,0,0
"shootout:pidigits/pidigits","eval",8,6,6,0,6,6,0,0,0,0,5,1,0,0,0,0,0,0
"shootout:pidigits/pidigits",".deparseOpts",83,30,22,10,20,12,8,2,0,8,14,4,2,0,2,0,0,0
"shootout:pidigits/pidigits","deparse",11,11,11,2,9,9,1,1,0,0,8,1,0,0,0,0,0,0
"shootout:pidigits/pidigits","%in%",8,8,8,3,5,2,1,2,0,3,0,2,4,2,2,0,2,0
"shootout:pidigits/pidigits","mode",27,21,21,5,16,15,1,4,0,1,14,2,2,2,0,0,2,0
"shootout:pidigits/pidigits","substr",13,7,7,4,3,3,2,2,0,0,2,1,2,2,0,0,2,0
"shootout:pidigits/pidigits","nchar",4,4,4,0,4,1,0,0,0,3,4,0,0,0,0,0,0,0
"shootout:pidigits/pidigits","substr",13,9,9,5,4,4,2,3,0,0,2,2,3,2,1,0,2,0
"shootout:pidigits/pidigits","match.fun",40,3,3,1,2,1,0,1,0,1,1,1,0,0,0,0,0,0
"shootout:pidigits/pidigits","unknown--fromConstant",9,5,5,2,3,2,2,0,0,1,2,1,3,0,3,0,0,0
"shootout:pidigits/pidigits","is.logint",9,4,4,0,4,1,0,0,0,3,4,0,0,0,0,0,0,0
"shootout:pidigits/pidigits","integer",1,1,1,1,0,0,1,0,0,0,0,0,0,0,0,0,0,0
"shootout:pidigits/pidigits","unknown--fromConstant",7,7,7,4,3,1,2,2,0,2,2,1,4,2,2,0,2,0
"shootout:pidigits/pidigits","cmp_mag",54,28,27,11,17,8,6,5,0,9,16,1,10,5,5,0,5,0
"shootout:pidigits/pidigits","unknown--fromConstant",56,24,22,4,20,5,4,0,0,15,20,0,0,0,0,0,0,0
"shootout:pidigits/pidigits","unknown--fromConstant",61,20,20,13,7,7,4,9,0,0,6,1,14,9,5,0,9,0
"shootout:pidigits/pidigits","integer",1,1,1,0,1,1,0,0,0,0,0,1,0,0,0,0,0,0
"shootout:pidigits/pidigits","mul",93,49,37,16,33,17,13,3,0,16,31,1,16,3,13,0,3,0
"shootout:pidigits/pidigits","seq",487,67,67,24,43,29,21,3,0,14,42,1,0,0,0,0,0,0
"shootout:pidigits/pidigits","multiply_mag",132,41,41,22,19,7,16,6,0,12,17,1,10,6,4,0,6,0
"shootout:pidigits/pidigits","chkDots",15,1,1,1,0,0,1,0,0,0,0,0,0,0,0,0,0,0
"shootout:pidigits/pidigits","cmp",30,15,15,8,7,7,3,5,0,0,7,0,12,5,7,0,5,0
"shootout:pidigits/pidigits","sapply",32,24,23,6,18,14,4,2,0,4,14,3,0,0,0,0,0,0
"shootout:pidigits/pidigits","str_to_mag",59,34,34,11,23,16,8,3,0,7,17,5,4,2,2,0,2,0
"shootout:pidigits/pidigits","strip_leading_zeros",54,27,26,9,18,14,4,5,0,4,16,2,7,2,5,0,2,0
"shootout:pidigits/pidigits","lapply",17,13,12,0,13,11,0,0,0,2,8,3,6,0,6,0,0,0
"shootout:pidigits/pidigits","unlist",27,5,5,0,5,5,0,0,0,0,5,0,2,0,2,0,0,0
"shootout:pidigits/pidigits","simplify2array",151,23,22,8,15,10,7,1,0,5,15,0,2,0,2,0,0,0
"shootout:pidigits/pidigits","unknown--fromConstant",2,2,2,1,1,1,0,1,0,0,0,1,0,0,0,0,0,0
"shootout:pidigits/pidigits","unique",1,0,0,0,0,0,0,0,0,0,0,0,0,0,0,0,0,0
"shootout:pidigits/pidigits","add_mag",139,53,53,29,24,12,21,8,0,12,23,0,8,8,0,0,8,0
"shootout:pidigits/pidigits","unknown--fromConstant",61,46,46,19,27,25,10,9,0,2,26,1,14,9,5,0,9,0
"shootout:pidigits/pidigits","unknown--fromConstant",56,24,23,7,17,5,7,0,0,12,17,0,0,0,0,0,0,0
"shootout:pidigits/pidigits","unknown--fromConstant",7,7,5,4,3,1,2,2,0,2,2,1,4,2,2,0,2,0
"shootout:pidigits/pidigits","sub_mag",106,39,39,18,21,10,14,4,0,11,20,0,3,3,0,0,3,0
"shootout:pidigits/pidigits","unknown--fromConstant",56,24,23,2,22,9,2,0,0,13,22,0,6,0,6,0,0,0
"shootout:pidigits/pidigits","unknown--fromConstant",9,5,5,1,4,3,1,0,0,1,3,1,4,0,4,0,0,0
"shootout:pidigits/pidigits","mul",30,18,18,7,11,11,5,2,0,0,10,1,13,3,10,1,2,0
"shootout:pidigits/pidigits","sub_mag",106,49,49,22,27,14,16,5,1,13,26,0,8,7,1,3,4,0
"shootout:pidigits/pidigits","sub",62,38,38,15,23,21,11,4,0,2,23,0,8,4,4,0,4,0
"shootout:pidigits/pidigits","lt",34,19,19,9,10,9,4,5,0,1,9,1,14,5,9,0,5,0
"shootout:pidigits/pidigits","multiply_mag",132,97,97,45,52,25,37,8,0,27,50,1,13,8,5,0,8,0
"shootout:pidigits/pidigits","unknown--fromConstant",61,46,46,18,28,26,9,9,0,2,28,0,18,11,7,2,9,0
"shootout:pidigits/pidigits","div2",105,26,25,6,20,11,4,2,0,9,18,1,4,0,4,0,0,0
"shootout:pidigits/pidigits","add_mag",139,77,77,19,58,22,9,10,0,36,57,0,11,8,3,0,8,0
"shootout:pidigits/pidigits","le",34,19,19,9,10,9,4,5,0,1,9,1,12,5,7,0,5,0
"shootout:pidigits/pidigits","unknown--fromConstant",7,7,7,3,4,2,2,1,0,2,3,1,4,1,3,0,1,0
"shootout:pidigits/pidigits","log10_mag",14,8,8,4,4,4,4,0,0,0,4,0,1,1,0,1,0,0
"shootout:pidigits/pidigits","cmp_elem",7,7,7,4,3,1,2,2,0,2,2,1,4,2,2,0,2,0
"shootout:pidigits/pidigits","cmp_mag",54,36,35,13,23,12,8,5,0,11,22,1,10,5,5,0,5,0
"shootout:pidigits/pidigits","ge",34,19,19,9,10,9,4,5,0,1,9,1,12,5,7,0,5,0
"shootout:pidigits/pidigits","add_mag",139,86,86,29,57,25,19,10,0,32,56,0,11,10,1,2,8,0
"shootout:pidigits/pidigits","bigint_pow10",25,12,11,2,10,8,2,0,0,2,9,1,0,0,0,0,0,0
"shootout:pidigits/pidigits","unknown--fromConstant",61,46,46,18,28,26,8,10,0,2,28,0,23,12,11,2,10,0
"shootout:pidigits/pidigits","rep.int",2,2,2,2,0,0,2,0,0,0,0,0,0,0,0,0,0,0
"shootout:pidigits/pidigits","sub",62,38,38,13,25,23,9,4,0,2,25,0,16,5,11,1,4,0
"shootout:pidigits/pidigits","multiply_mag",132,97,97,47,50,24,37,10,0,26,48,1,16,10,6,0,10,0
"shootout:pidigits/pidigits","seq",489,87,84,29,58,42,25,4,0,16,57,1,2,2,0,2,0,0
"shootout:pidigits/pidigits","gt",34,19,19,9,10,9,4,5,0,1,9,1,12,5,7,0,5,0
"shootout:pidigits/pidigits","mul",30,18,18,9,9,9,5,4,0,0,8,1,13,5,8,1,4,0
"shootout:pidigits/pidigits","cmp",30,15,15,9,6,6,3,6,0,0,6,0,12,6,6,0,6,0
"shootout:pidigits/pidigits","unknown--fromConstant",61,46,46,15,31,26,8,7,0,5,31,0,23,9,14,2,7,0
"shootout:pidigits/pidigits","mul",30,18,18,9,9,9,5,4,0,0,8,1,13,5,8,1,4,0
"shootout:pidigits/pidigits","unknown--fromConstant",7,7,5,4,3,1,2,2,0,2,2,1,4,2,2,0,2,0
"shootout:pidigits/pidigits","div",36,23,23,4,19,17,3,1,0,2,18,1,6,1,5,0,1,0
"shootout:pidigits/pidigits","unknown--fromConstant",273,153,151,41,112,89,32,9,0,23,105,5,32,11,21,3,8,0
"shootout:pidigits/pidigits","sub",62,38,38,13,25,23,9,4,0,2,25,0,16,5,11,1,4,0
"shootout:pidigits/pidigits","add_mag",139,99,99,35,64,31,24,11,0,33,63,0,11,10,1,2,8,0
"shootout:pidigits/pidigits","sub_mag",106,60,60,25,35,20,19,6,0,15,34,0,9,7,2,3,4,0
"shootout:pidigits/pidigits","to_int",40,18,18,10,8,5,6,4,0,3,7,1,6,4,2,0,4,0
"shootout:pidigits/pidigits","add_mag",139,99,99,35,64,31,23,12,0,33,63,0,11,10,1,2,8,0
"shootout:pidigits/pidigits","nchar",4,4,4,1,3,0,0,1,0,3,3,0,0,0,0,0,0,0
"shootout:pidigits/pidigits","stdout",0,0,0,0,0,0,0,0,0,0,0,0,0,0,0,0,0,0
"shootout:pidigits/pidigits","zeropad",13,8,5,0,8,5,0,0,0,3,3,2,1,0,1,0,0,0
"shootout:pidigits/pidigits","Sys.time",8,5,5,0,5,5,0,0,0,0,2,3,0,0,0,0,0,0
"shootout:pidigits/pidigits","execute",2,2,2,0,2,2,0,0,0,0,0,2,0,0,0,0,0,0
"shootout:pidigits/pidigits","bigint",39,23,21,9,14,8,6,3,0,6,11,2,9,3,6,1,2,0
"shootout:pidigits/pidigits","bigint",39,23,20,12,11,8,6,6,0,3,9,2,9,4,5,1,3,0
"shootout:pidigits/pidigits","pidigits",463,337,325,94,243,220,61,33,0,23,233,8,80,34,46,5,29,0
"shootout:pidigits/pidigits","str_to_mag",59,34,34,11,23,16,8,3,0,7,17,5,4,2,2,0,2,0
"shootout:pidigits/pidigits","unknown--fromConstant",7,7,5,4,3,1,2,2,0,2,2,1,4,2,2,0,2,0
"shootout:pidigits/pidigits","div",36,23,21,4,19,17,3,1,0,2,18,1,6,1,5,0,1,0
"shootout:pidigits/pidigits","cmp",30,15,15,9,6,6,3,6,0,0,6,0,12,6,6,0,6,0
"shootout:pidigits/pidigits","cmp",30,15,15,9,6,6,3,6,0,0,6,0,12,6,6,0,6,0
"shootout:pidigits/pidigits","sub",62,38,38,13,25,23,9,4,0,2,25,0,16,5,11,1,4,0
"shootout:pidigits/pidigits","to_int",40,18,18,14,4,4,8,6,0,0,3,1,6,6,0,0,6,0
"shootout:pidigits/pidigits","bigint",39,23,21,9,14,8,5,4,0,6,11,2,9,3,6,1,2,0
"shootout:pidigits/pidigits","str_to_mag",59,34,34,11,23,16,8,3,0,7,17,5,4,2,2,0,2,0
"shootout:fannkuch/fannkuchredux_naive","match",4,4,4,1,3,1,0,1,0,2,0,1,2,1,1,0,1,0
"shootout:fannkuch/fannkuchredux_naive","stdout",0,0,0,0,0,0,0,0,0,0,0,0,0,0,0,0,0,0
"shootout:fannkuch/fannkuchredux_naive","Sys.time",8,5,5,0,5,5,0,0,0,0,2,3,0,0,0,0,0,0
"shootout:fannkuch/fannkuchredux_naive","execute",39,22,14,0,22,7,0,0,0,15,16,3,2,0,2,0,0,0
"shootout:fannkuch/fannkuchredux_naive","fannkuch",193,133,123,2,131,41,2,0,0,90,127,2,2,0,2,0,0,0
"areWeFast:Mandelbrot","match",4,4,4,2,2,1,0,2,0,1,0,1,2,2,0,0,2,0
"areWeFast:Mandelbrot","%in%",8,8,8,2,6,3,1,1,0,3,0,3,4,1,3,0,1,0
"areWeFast:Mandelbrot",".deparseOpts",83,30,22,10,20,12,8,2,0,8,14,4,2,0,2,0,0,0
"areWeFast:Mandelbrot","mode",27,21,21,4,17,15,1,3,0,2,15,2,2,1,1,0,1,0
"areWeFast:Mandelbrot","bitwShiftL",2,2,2,0,2,2,0,0,0,0,2,0,0,0,0,0,0,0
"areWeFast:Mandelbrot","bitwXor",2,2,2,0,2,2,0,0,0,0,0,2,1,0,1,0,0,0
"areWeFast:Mandelbrot","bitwShiftL",2,2,2,1,1,1,1,0,0,0,1,0,0,0,0,0,0,0
"areWeFast:Mandelbrot","bitwXor",2,2,2,0,2,2,0,0,0,0,2,0,2,0,2,0,0,0
"areWeFast:Mandelbrot","Sys.time",8,5,5,0,5,5,0,0,0,0,2,3,0,0,0,0,0,0
"areWeFast:Mandelbrot","mandelbrot",99,99,96,1,98,42,0,1,0,56,97,0,3,0,3,0,0,0
"areWeFast:Mandelbrot","stdout",0,0,0,0,0,0,0,0,0,0,0,0,0,0,0,0,0,0
"areWeFast:Mandelbrot","verifyResult",20,4,4,1,3,3,1,0,0,0,3,0,0,0,0,0,0,0
"areWeFast:Mandelbrot","execute",2,2,2,1,1,1,1,0,0,0,1,0,0,0,0,0,0,0
"areWeFast:Mandelbrot","mandelbrot",99,99,55,2,97,41,1,1,0,56,96,0,3,0,3,0,0,0
"RealThing:flexclust_no_s4","match",4,4,4,2,2,1,0,2,0,1,0,1,2,2,0,0,2,0
"RealThing:flexclust_no_s4","%in%",8,8,8,2,6,3,1,1,0,3,0,3,4,1,3,0,1,0
"RealThing:flexclust_no_s4",".deparseOpts",83,30,22,10,20,12,8,2,0,8,14,4,2,0,2,0,0,0
"RealThing:flexclust_no_s4","mode",27,21,21,4,17,15,1,3,0,2,15,2,2,1,1,0,1,0
"RealThing:flexclust_no_s4","withVisible",3,1,1,0,1,1,0,0,0,0,0,1,0,0,0,0,0,0
"RealThing:flexclust_no_s4","unknown--fromConstant",8,6,6,0,6,6,0,0,0,0,5,1,0,0,0,0,0,0
"RealThing:flexclust_no_s4",".deparseOpts",83,30,22,10,20,12,8,2,0,8,14,4,2,0,2,0,0,0
"RealThing:flexclust_no_s4","deparse",11,11,11,2,9,9,1,1,0,0,8,1,0,0,0,0,0,0
"RealThing:flexclust_no_s4","pmatch",8,6,6,1,5,4,0,1,0,1,3,1,0,0,0,0,0,0
"RealThing:flexclust_no_s4","%in%",8,8,8,3,5,3,1,2,0,2,0,3,4,2,2,0,2,0
"RealThing:flexclust_no_s4","unknown--fromConstant",8,6,6,1,5,5,0,1,0,0,5,0,1,1,0,0,1,0
"RealThing:flexclust_no_s4","identical",8,8,8,0,8,2,0,0,0,6,8,0,2,0,2,0,0,0
"RealThing:flexclust_no_s4","formals",10,3,3,1,2,2,0,1,0,0,1,1,0,0,0,0,0,0
"RealThing:flexclust_no_s4","match.arg",77,53,52,15,38,26,10,5,0,12,32,4,5,0,5,0,0,0
"RealThing:flexclust_no_s4","sys.function",1,1,1,1,0,0,1,0,0,0,0,0,0,0,0,0,0,0
"RealThing:flexclust_no_s4","sys.parent",1,1,1,0,1,0,0,0,0,1,0,0,0,0,0,0,0,0
"RealThing:flexclust_no_s4","sys.frame",1,1,1,0,1,1,0,0,0,0,0,1,0,0,0,0,0,0
"RealThing:flexclust_no_s4","mode",27,21,21,5,16,15,1,4,0,1,14,2,2,2,0,0,2,0
"RealThing:flexclust_no_s4","inherits",3,3,3,0,3,2,0,0,0,1,0,2,1,0,1,0,0,0
"RealThing:flexclust_no_s4","unknown--fromConstant",4,3,3,2,1,1,2,0,0,0,0,1,0,0,0,0,0,0
"RealThing:flexclust_no_s4","match",4,4,4,1,3,1,0,1,0,2,0,1,2,1,1,0,1,0
"RealThing:flexclust_no_s4","unknown--fromConstant",4,3,3,2,1,1,2,0,0,0,0,1,0,0,0,0,0,0
"RealThing:flexclust_no_s4","colSums",95,45,44,21,24,18,18,3,0,6,19,3,1,0,1,0,0,0
"RealThing:flexclust_no_s4","t",1,0,0,0,0,0,0,0,0,0,0,0,0,0,0,0,0,0
"RealThing:flexclust_no_s4","formals",10,3,3,0,3,3,0,0,0,0,2,1,0,0,0,0,0,0
"RealThing:flexclust_no_s4","is.data.frame",5,5,5,1,4,2,1,0,0,2,0,2,1,0,1,0,0,0
"RealThing:flexclust_no_s4","matrix",13,9,8,0,9,6,0,0,0,3,8,1,3,0,3,0,0,0
"RealThing:flexclust_no_s4","colMeans",95,45,44,19,26,20,16,3,0,6,21,3,1,0,1,0,0,0
"RealThing:flexclust_no_s4","distEuclidean",95,52,46,11,41,28,11,0,0,13,37,3,3,0,3,0,0,0
"RealThing:flexclust_no_s4","unknown--fromConstant",4,3,3,1,2,2,1,0,0,0,0,2,0,0,0,0,0,0
"RealThing:flexclust_no_s4","as.matrix",1,0,0,0,0,0,0,0,0,0,0,0,0,0,0,0,0,0
"RealThing:flexclust_no_s4","unknown--fromConstant",8,7,7,1,6,6,0,1,0,0,6,0,1,1,0,0,1,0
"RealThing:flexclust_no_s4","match.arg",77,53,52,15,38,26,10,5,0,12,32,4,5,0,5,0,0,0
"RealThing:flexclust_no_s4","as.matrix",1,0,0,0,0,0,0,0,0,0,0,0,0,0,0,0,0,0
"RealThing:flexclust_no_s4","max.col",24,15,14,4,11,8,2,2,0,3,6,3,0,0,0,0,0,0
"RealThing:flexclust_no_s4","parent.frame",1,1,1,0,1,0,0,0,0,1,0,0,0,0,0,0,0,0
"RealThing:flexclust_no_s4","kmeansAllcent",70,35,29,12,23,12,11,1,0,11,22,0,3,0,3,0,0,0
"RealThing:flexclust_no_s4","match.arg",77,53,52,15,38,26,10,5,0,12,32,4,5,0,5,0,0,0
"RealThing:flexclust_no_s4","match.fun",40,3,3,1,2,1,0,1,0,1,1,1,2,1,1,0,1,0
"RealThing:flexclust_no_s4","is.vector",2,2,1,0,2,1,0,0,0,1,0,1,0,0,0,0,0,0
"RealThing:flexclust_no_s4","vapply",17,9,8,0,9,7,0,0,0,2,6,1,2,0,2,0,0,0
"RealThing:flexclust_no_s4","logical",1,1,1,0,1,1,0,0,0,0,0,1,0,0,0,0,0,0
"RealThing:flexclust_no_s4","is.factor",5,5,5,1,4,2,1,0,0,2,0,2,2,0,2,0,0,0
"RealThing:flexclust_no_s4","FUN",14,5,5,1,4,2,1,0,0,2,4,0,0,0,0,0,0,0
"RealThing:flexclust_no_s4","rep_len",2,2,2,2,0,0,2,0,0,0,0,0,0,0,0,0,0,0
"RealThing:flexclust_no_s4","sort.list",84,34,33,13,21,16,6,7,0,5,21,0,0,0,0,0,0,0
"RealThing:flexclust_no_s4","",9,5,5,0,5,5,0,0,0,0,2,3,0,0,0,0,0,0
"RealThing:flexclust_no_s4","which",12,3,2,2,1,0,2,0,0,1,0,0,0,0,0,0,0,0
"RealThing:flexclust_no_s4","FUN",16,7,6,2,5,2,2,0,0,3,1,2,0,0,0,0,0,0
"RealThing:flexclust_no_s4","FUN",16,7,6,2,5,2,2,0,0,3,1,2,0,0,0,0,0,0
"RealThing:flexclust_no_s4","inherits",3,3,3,0,3,3,0,0,0,0,0,3,1,0,1,0,0,0
"RealThing:flexclust_no_s4","%in%",8,8,8,3,5,3,3,0,0,2,1,2,6,3,3,3,0,0
"RealThing:flexclust_no_s4",".deparseOpts",87,34,33,11,23,13,8,3,0,10,15,2,6,1,5,1,0,0
"RealThing:flexclust_no_s4","lengths",2,2,2,0,2,1,0,0,0,1,0,1,0,0,0,0,0,0
"RealThing:flexclust_no_s4","unlist",27,5,5,0,5,5,0,0,0,0,5,0,2,0,2,0,0,0
"RealThing:flexclust_no_s4","lapply",17,13,12,0,13,11,0,0,0,2,10,1,4,0,4,0,0,0
"RealThing:flexclust_no_s4","FUN",1,0,0,0,0,0,0,0,0,0,0,0,0,0,0,0,0,0
"RealThing:flexclust_no_s4","array",53,7,7,3,4,1,0,3,0,3,4,0,5,3,2,0,3,0
"RealThing:flexclust_no_s4","FUN",6,4,3,0,4,2,0,0,0,2,4,0,0,0,0,0,0,0
"RealThing:flexclust_no_s4","matrix",13,9,7,1,8,4,0,1,0,4,7,1,5,1,4,0,1,0
"RealThing:flexclust_no_s4","vector",2,2,2,0,2,2,0,0,0,0,0,2,1,0,1,0,0,0
"RealThing:flexclust_no_s4","is.factor",5,5,5,1,4,2,1,0,0,2,0,2,2,0,2,0,0,0
"RealThing:flexclust_no_s4","FUN",14,9,9,4,5,4,3,1,0,1,4,1,1,1,0,0,1,0
"RealThing:flexclust_no_s4","as.list",1,0,0,0,0,0,0,0,0,0,0,0,0,0,0,0,0,0
"RealThing:flexclust_no_s4","match",4,4,4,1,3,1,0,0,1,2,0,1,2,1,1,0,0,1
"RealThing:flexclust_no_s4",".row_names_info",2,2,2,0,2,1,0,0,0,1,0,1,1,0,1,0,0,0
"RealThing:flexclust_no_s4","force",1,1,1,1,0,0,0,1,0,0,0,0,1,1,0,0,1,0
"RealThing:flexclust_no_s4",".set_row_names",6,4,4,0,4,3,0,0,0,1,2,2,0,0,0,0,0,0
"RealThing:flexclust_no_s4","unknown--fromConstant",4,3,3,2,1,1,2,0,0,0,0,1,0,0,0,0,0,0
"RealThing:flexclust_no_s4","array",55,16,16,7,9,5,1,6,0,4,7,1,6,4,2,0,4,0
"RealThing:flexclust_no_s4","distEuclidean",91,49,43,11,38,26,11,0,0,12,35,2,5,0,5,0,0,0
"RealThing:flexclust_no_s4","unknown--fromConstant",4,3,3,2,1,1,2,0,0,0,0,1,0,0,0,0,0,0
"RealThing:flexclust_no_s4","unknown--fromConstant",4,3,3,2,1,1,2,0,0,0,0,1,0,0,0,0,0,0
"RealThing:flexclust_no_s4","unknown--fromConstant",4,3,3,1,2,2,1,0,0,0,0,2,0,0,0,0,0,0
"RealThing:flexclust_no_s4","mostattributes<-",110,42,41,12,30,21,11,1,0,9,23,4,2,1,1,1,0,0
"RealThing:flexclust_no_s4","isTRUE",11,8,7,1,7,1,1,0,0,6,6,0,0,0,0,0,0,0
"RealThing:flexclust_no_s4","aperm",1,0,0,0,0,0,0,0,0,0,0,0,0,0,0,0,0,0
"RealThing:flexclust_no_s4","unlist",27,5,5,0,5,5,0,0,0,0,5,0,2,0,2,0,0,0
"RealThing:flexclust_no_s4","as.vector",2,2,2,0,2,2,0,0,0,0,0,2,1,0,1,0,0,0
"RealThing:flexclust_no_s4","integer",1,1,1,0,1,0,0,0,0,1,0,0,0,0,0,0,0,0
"RealThing:flexclust_no_s4","is.factor",5,5,5,1,4,2,1,0,0,2,0,2,2,0,2,0,0,0
"RealThing:flexclust_no_s4","typeof",1,1,1,0,1,1,0,0,0,0,0,1,1,0,1,0,0,0
"RealThing:flexclust_no_s4","deparse",11,11,11,2,9,9,1,1,0,0,8,1,2,1,1,0,1,0
"RealThing:flexclust_no_s4","lapply",17,13,12,0,13,11,0,0,0,2,10,1,4,0,4,0,0,0
"RealThing:flexclust_no_s4","unique",1,0,0,0,0,0,0,0,0,0,0,0,0,0,0,0,0,0
"RealThing:flexclust_no_s4","vapply",17,11,10,0,11,9,0,0,0,2,7,2,4,0,4,0,0,0
"RealThing:flexclust_no_s4","as.list",1,0,0,0,0,0,0,0,0,0,0,0,0,0,0,0,0,0
"RealThing:flexclust_no_s4","tapply",239,110,106,33,77,64,24,9,0,13,70,5,10,3,7,0,3,0
"RealThing:flexclust_no_s4","split",1,0,0,0,0,0,0,0,0,0,0,0,0,0,0,0,0,0
"RealThing:flexclust_no_s4","FUN",1,0,0,0,0,0,0,0,0,0,0,0,0,0,0,0,0,0
"RealThing:flexclust_no_s4","vector",2,2,2,1,1,0,0,1,0,1,0,0,1,0,1,0,0,0
"RealThing:flexclust_no_s4",".doSortWrap",53,19,19,9,10,9,7,2,0,1,10,0,0,0,0,0,0,0
"RealThing:flexclust_no_s4","sort.int",239,37,35,11,26,20,7,4,0,6,26,0,0,0,0,0,0,0
"RealThing:flexclust_no_s4","matrix",13,9,9,2,7,5,1,1,0,2,6,1,5,2,3,1,1,0
"RealThing:flexclust_no_s4","unique.default",52,6,6,0,6,1,0,0,0,5,6,0,2,0,2,0,0,0
"RealThing:flexclust_no_s4","Sys.time",8,5,5,0,5,5,0,0,0,0,2,3,0,0,0,0,0,0
"RealThing:flexclust_no_s4","stdout",0,0,0,0,0,0,0,0,0,0,0,0,0,0,0,0,0,0
"RealThing:flexclust_no_s4","integer",1,1,1,0,1,1,0,0,0,0,0,1,0,0,0,0,0,0
"RealThing:flexclust_no_s4","unlist",27,5,5,1,4,4,0,1,0,0,4,0,2,1,1,0,1,0
"RealThing:flexclust_no_s4","FUN",33,22,22,6,16,14,4,2,0,2,11,3,2,2,0,1,1,0
"RealThing:flexclust_no_s4","aperm",1,0,0,0,0,0,0,0,0,0,0,0,0,0,0,0,0,0
"RealThing:flexclust_no_s4","apply",377,165,160,57,108,64,40,17,0,44,101,3,14,3,11,0,3,0
"RealThing:flexclust_no_s4","array",55,16,11,6,10,3,1,5,0,7,8,1,6,3,3,0,3,0
"RealThing:flexclust_no_s4","isFALSE",11,8,7,1,7,1,1,0,0,6,6,0,0,0,0,0,0,0
"RealThing:flexclust_no_s4","unique",1,0,0,0,0,0,0,0,0,0,0,0,0,0,0,0,0,0
"RealThing:flexclust_no_s4","is.vector",2,2,1,1,1,0,0,1,0,1,0,0,0,0,0,0,0,0
"RealThing:flexclust_no_s4","sys.call",1,1,1,0,1,0,0,0,0,1,0,0,0,0,0,0,0,0
"RealThing:flexclust_no_s4","distEuclidean",91,49,33,11,38,26,11,0,0,12,35,2,5,0,5,0,0,0
"RealThing:flexclust_no_s4","distEuclidean",91,49,43,11,38,26,11,0,0,12,35,2,5,0,5,0,0,0
"RealThing:flexclust_no_s4","kmeanspp",86,41,35,11,30,20,11,0,0,10,29,0,5,0,5,0,0,0
"RealThing:flexclust_no_s4","summarizeCenters",112,83,74,6,77,70,6,0,0,7,69,6,2,0,2,0,0,0
"RealThing:flexclust_no_s4","t",1,0,0,0,0,0,0,0,0,0,0,0,0,0,0,0,0,0
"RealThing:flexclust_no_s4","kmeansCluster",37,25,21,8,17,15,6,2,0,2,15,2,0,0,0,0,0,0
"RealThing:flexclust_no_s4","kmeansCluster",37,25,21,8,17,15,6,2,0,2,15,2,0,0,0,0,0,0
"RealThing:flexclust_no_s4","append",54,11,11,7,4,4,3,4,0,0,3,1,0,0,0,0,0,0
"RealThing:flexclust_no_s4","kcca",291,162,153,39,123,103,36,3,0,20,114,7,5,0,5,0,0,0
"RealThing:flexclust_no_s4","unknown--fromConstant",4,3,3,2,1,1,2,0,0,0,0,1,0,0,0,0,0,0
"RealThing:flexclust_no_s4","unknown--fromConstant",4,3,3,2,1,1,2,0,0,0,0,1,0,0,0,0,0,0
"RealThing:flexclust_no_s4","unknown--fromConstant",4,3,3,1,2,2,1,0,0,0,0,2,0,0,0,0,0,0
"RealThing:flexclust_no_s4","kmeansAllcent",70,35,19,13,22,11,12,1,0,11,21,0,5,0,5,0,0,0
"RealThing:flexclust_no_s4","na.omit",1,0,0,0,0,0,0,0,0,0,0,0,0,0,0,0,0,0
"RealThing:flexclust_no_s4","computeClusterSim",369,118,100,41,77,38,37,4,0,39,75,1,6,0,6,0,0,0
"RealThing:flexclust_no_s4","is.ordered",5,5,5,1,4,2,1,0,0,2,0,2,1,0,1,0,0,0
"RealThing:flexclust_no_s4","FUN",11,6,6,2,4,4,1,1,0,0,2,2,0,0,0,0,0,0
"RealThing:flexclust_no_s4","tabulate",28,16,16,3,13,9,2,1,0,4,10,2,1,0,1,0,0,0
"RealThing:flexclust_no_s4","make.names",20,18,18,4,14,11,1,3,0,3,11,2,0,0,0,0,0,0
"RealThing:flexclust_no_s4","unknown--fromConstant",4,3,3,2,1,1,2,0,0,0,0,1,0,0,0,0,0,0
"RealThing:flexclust_no_s4","unknown--fromConstant",4,3,3,2,1,1,2,0,0,0,0,1,0,0,0,0,0,0
"RealThing:flexclust_no_s4","kcca",287,159,150,39,120,102,36,3,0,18,112,6,5,0,5,0,0,0
"RealThing:flexclust_no_s4","unknown--fromConstant",4,3,3,2,1,1,2,0,0,0,0,1,0,0,0,0,0,0
"RealThing:flexclust_no_s4","unknown--fromConstant",4,3,3,2,1,1,2,0,0,0,0,1,0,0,0,0,0,0
"RealThing:flexclust_no_s4","unknown--fromConstant",4,3,3,1,2,2,1,0,0,0,0,2,0,0,0,0,0,0
"RealThing:flexclust_no_s4","kmeansAllcent",70,35,19,13,22,11,12,1,0,11,21,0,5,0,5,0,0,0
"RealThing:flexclust_no_s4","execute",36,20,13,0,20,11,0,0,0,9,14,4,2,0,2,0,0,0
"RealThing:flexclust_no_s4","set.seed",84,11,5,1,10,4,1,0,0,6,9,1,0,0,0,0,0,0
"RealThing:flexclust_no_s4","numeric",1,1,1,0,1,1,0,0,0,0,0,1,0,0,0,0,0,0
"RealThing:flexclust_no_s4","asplit",162,86,83,30,56,36,18,12,0,20,52,2,7,4,3,0,4,0
"RealThing:flexclust_no_s4","do.call",9,6,6,1,5,5,0,1,0,0,3,2,0,0,0,0,0,0
"RealThing:flexclust_no_s4",".row_names_info",2,2,2,0,2,2,0,0,0,0,0,2,1,0,1,0,0,0
"RealThing:flexclust_no_s4","array",55,16,16,6,10,4,1,5,0,6,8,1,6,3,3,0,3,0
"RealThing:flexclust_no_s4","apply",377,165,160,57,108,64,40,17,0,44,101,3,14,3,11,0,3,0
"RealThing:flexclust_no_s4","array",55,16,11,6,10,3,1,5,0,7,8,1,6,3,3,0,3,0
"RealThing:flexclust_no_s4","match",4,4,4,1,3,1,1,0,0,2,0,1,2,1,1,1,0,0
"RealThing:flexclust_no_s4","vector",2,2,2,1,1,1,0,1,0,0,0,1,1,1,0,0,1,0
"kaggle:titanic","match.fun",40,3,3,1,2,1,0,1,0,1,1,1,2,1,1,0,1,0
"kaggle:titanic","inherits",3,3,3,0,3,3,0,0,0,0,0,3,1,0,1,0,0,0
"kaggle:titanic","is.vector",2,2,1,0,2,1,0,0,0,1,0,1,1,0,1,0,0,0
"kaggle:titanic","lapply",17,13,12,0,13,11,0,0,0,2,10,1,9,0,9,0,0,0
"kaggle:titanic","is.numeric_version",5,5,5,1,4,2,1,0,0,2,0,2,2,0,2,0,0,0
"kaggle:titanic","nchar",4,4,4,0,4,1,0,0,0,3,2,1,0,0,0,0,0,0
"kaggle:titanic","match",4,4,4,1,3,2,0,1,0,1,1,1,1,0,1,0,0,0
"kaggle:titanic","unique",1,0,0,0,0,0,0,0,0,0,0,0,0,0,0,0,0,0
"kaggle:titanic","is.factor",5,5,5,1,4,2,1,0,0,2,0,2,2,0,2,0,0,0
"kaggle:titanic","unlist",27,5,5,0,5,4,0,0,0,1,5,0,2,0,2,0,0,0
"kaggle:titanic",".make_numeric_version",124,61,59,16,45,39,7,9,0,6,34,6,13,2,11,1,1,0
"kaggle:titanic","integer",1,1,1,0,1,0,0,0,0,1,0,0,0,0,0,0,0,0
"kaggle:titanic","FUN",48,19,19,4,15,13,4,0,0,2,7,6,3,0,3,0,0,0
"kaggle:titanic","strrep",10,5,5,1,4,3,1,0,0,1,3,1,0,0,0,0,0,0
"kaggle:titanic","%in%",8,8,8,3,5,3,1,2,0,2,0,3,5,2,3,1,1,0
"kaggle:titanic","unknown--fromConstant",5,4,4,0,4,3,0,0,0,1,2,2,0,0,0,0,0,0
"kaggle:titanic","identical",8,8,8,0,8,8,0,0,0,0,8,0,2,0,2,0,0,0
"kaggle:titanic","asNamespace",28,22,22,4,18,11,4,0,0,7,17,1,2,0,2,0,0,0
"kaggle:titanic","isNamespace",1,1,1,0,1,1,0,0,0,0,0,1,0,0,0,0,0,0
"kaggle:titanic","isBaseNamespace",11,11,11,1,10,4,1,0,0,6,10,0,2,0,2,0,0,0
"kaggle:titanic","sys.frame",1,1,1,0,1,1,0,0,0,0,0,1,0,0,0,0,0,0
"kaggle:titanic","match",4,4,4,1,3,1,0,1,0,2,0,1,1,0,1,0,0,0
"kaggle:titanic",".identC",7,4,4,1,3,3,1,0,0,0,0,3,1,0,1,0,0,0
"kaggle:titanic","getClassDef",49,10,10,0,10,7,0,0,0,3,4,5,0,0,0,0,0,0
"kaggle:titanic",".getClassesFromCache",7,4,4,0,4,4,0,0,0,0,0,4,0,0,0,0,0,0
"kaggle:titanic","is",124,39,39,12,27,22,6,6,0,5,23,4,1,0,1,0,0,0
"kaggle:titanic","getClassDef",49,10,10,0,10,7,0,0,0,3,4,5,0,0,0,0,0,0
"kaggle:titanic","getClassDef",49,10,10,0,10,7,0,0,0,3,4,5,0,0,0,0,0,0
"kaggle:titanic","parent.frame",1,1,1,0,1,1,0,0,0,0,0,1,0,0,0,0,0,0
"kaggle:titanic","get0",6,5,5,0,5,5,0,0,0,0,0,5,3,0,3,0,0,0
"kaggle:titanic","typeof",1,1,1,0,1,1,0,0,0,0,0,1,1,0,1,0,0,0
"kaggle:titanic","parent.env",1,1,1,0,1,1,0,0,0,0,0,1,0,0,0,0,0,0
"kaggle:titanic","asNamespace",28,24,24,5,19,13,4,1,0,6,17,2,2,0,2,0,0,0
"kaggle:titanic",".registerS3method",77,39,39,10,29,24,2,8,0,5,18,7,4,0,4,0,0,0
"kaggle:titanic","delayedAssign",7,5,5,1,4,4,0,1,0,0,3,1,0,0,0,0,0,0
"kaggle:titanic","asNamespace",33,27,26,4,23,15,4,0,0,8,19,4,3,0,3,0,0,0
"kaggle:titanic","environment",1,1,1,1,0,0,0,1,0,0,0,0,1,1,0,0,1,0
"kaggle:titanic","asNamespace",33,27,26,5,22,15,4,1,0,7,19,3,3,1,2,0,1,0
"kaggle:titanic",".registerS3method",77,41,41,10,31,26,2,8,0,5,21,6,7,1,6,0,1,0
"kaggle:titanic","asNamespace",33,27,20,4,23,15,4,0,0,8,19,4,3,0,3,0,0,0
"kaggle:titanic","setNamespaceInfo",7,7,7,4,3,2,1,3,0,1,3,0,1,1,0,1,0,0
"kaggle:titanic",".getNamespaceInfo",5,4,4,2,2,2,0,2,0,0,1,1,1,0,1,0,0,0
"kaggle:titanic","%in%",8,8,8,2,6,3,1,1,0,3,0,3,5,1,4,1,0,0
"kaggle:titanic","character",1,1,1,0,1,0,0,0,0,1,0,0,0,0,0,0,0,0
"kaggle:titanic","readRDS",21,11,11,0,11,10,0,0,0,1,8,3,0,0,0,0,0,0
"kaggle:titanic","isTRUE",11,8,7,4,4,1,3,1,0,3,3,0,1,1,0,0,1,0
"kaggle:titanic","FUN",3,3,2,0,3,2,0,0,0,1,0,2,0,0,0,0,0,0
"kaggle:titanic","FUN",8,8,5,0,8,5,0,0,0,3,2,3,2,0,2,0,0,0
"kaggle:titanic","strlpad",11,11,9,0,11,9,0,0,0,2,6,3,0,0,0,0,0,0
"kaggle:titanic","which",12,3,2,1,2,1,1,0,0,1,0,1,0,0,0,0,0,0
"kaggle:titanic","rep.int",2,2,2,2,0,0,1,1,0,0,0,0,2,2,0,1,1,0
"kaggle:titanic","new.env",4,4,3,2,2,0,1,1,0,2,0,0,1,1,0,0,1,0
"kaggle:titanic","asNamespace",33,27,26,4,23,15,4,0,0,8,19,4,3,0,3,0,0,0
"kaggle:titanic","is.vector",2,2,1,0,2,1,0,0,0,1,0,1,1,0,1,0,0,0
"kaggle:titanic",".standard_regexps",1,1,1,0,1,1,0,0,0,0,0,1,0,0,0,0,0,0
"kaggle:titanic","unknown--fromConstant",5,4,4,0,4,3,0,0,0,1,2,2,0,0,0,0,0,0
"kaggle:titanic","grepl",56,16,16,3,13,11,2,1,0,2,9,2,2,0,2,0,0,0
"kaggle:titanic","unique",1,0,0,0,0,0,0,0,0,0,0,0,0,0,0,0,0,0
"kaggle:titanic","unlist",27,5,5,0,5,5,0,0,0,0,5,0,2,0,2,0,0,0
"kaggle:titanic","lapply",17,16,15,0,16,14,0,0,0,2,13,1,9,0,9,0,0,0
"kaggle:titanic","as.list",1,0,0,0,0,0,0,0,0,0,0,0,0,0,0,0,0,0
"kaggle:titanic","setNamespaceInfo",7,7,7,4,3,2,1,3,0,1,3,0,1,1,0,1,0,0
"kaggle:titanic","getNamespaceName",23,22,22,5,17,10,2,3,0,7,14,2,3,0,3,0,0,0
"kaggle:titanic","%in%",8,8,8,2,6,3,1,1,0,3,0,3,5,1,4,1,0,0
"kaggle:titanic","startsWith",2,2,2,0,2,2,0,0,0,0,0,2,0,0,0,0,0,0
"kaggle:titanic","sys.frame",1,1,1,0,1,1,0,0,0,0,0,1,0,0,0,0,0,0
"kaggle:titanic","sys.nframe",0,0,0,0,0,0,0,0,0,0,0,0,0,0,0,0,0,0
"kaggle:titanic","get0",6,5,5,1,4,4,0,1,0,0,0,4,3,1,2,0,1,0
"kaggle:titanic","dynGet",108,70,66,17,53,41,11,6,0,12,47,2,12,3,9,0,3,0
"kaggle:titanic","environmentIsLocked",1,1,1,0,1,1,0,0,0,0,0,1,0,0,0,0,0,0
"kaggle:titanic","strsplit",7,6,4,2,4,2,1,1,0,2,4,0,0,0,0,0,0,0
"kaggle:titanic","parent.frame",1,1,1,0,1,0,0,0,0,1,0,0,0,0,0,0,0,0
"kaggle:titanic","get",6,4,4,1,3,3,0,1,0,0,0,3,1,1,0,0,1,0
"kaggle:titanic","getNamespaceInfo",6,6,6,0,6,6,0,0,0,0,4,2,1,0,1,0,0,0
"kaggle:titanic","environment",1,1,1,0,1,0,0,0,0,1,0,0,1,0,1,0,0,0
"kaggle:titanic","FUN",4,4,4,3,1,1,1,2,0,0,0,1,0,0,0,0,0,0
"kaggle:titanic","FUN",40,23,21,6,17,15,1,5,0,2,14,1,2,0,2,0,0,0
"kaggle:titanic","exists",8,4,4,1,3,3,0,1,0,0,1,2,0,0,0,0,0,0
"kaggle:titanic","tryCatchList",35,12,12,1,11,9,1,0,0,2,8,3,2,0,2,0,0,0
"kaggle:titanic","tryCatchOne",30,4,4,0,4,4,0,0,0,0,0,4,1,0,1,0,0,0
"kaggle:titanic","doTryCatch",7,6,6,0,6,5,0,0,0,1,3,3,0,0,0,0,0,0
"kaggle:titanic","vapply",17,11,10,0,11,9,0,0,0,2,6,3,6,0,6,0,0,0
"kaggle:titanic","",81,43,43,19,24,20,7,12,0,4,21,3,0,0,0,0,0,0
"kaggle:titanic","existsInFrame",2,2,2,1,1,1,0,1,0,0,0,1,0,0,0,0,0,0
"kaggle:titanic","parent.env<-",2,2,2,0,2,2,0,0,0,0,2,0,0,0,0,0,0,0
"kaggle:titanic","as.list",1,0,0,0,0,0,0,0,0,0,0,0,0,0,0,0,0,0
"kaggle:titanic","do.call",9,6,6,1,5,5,0,1,0,0,3,2,2,1,1,0,1,0
"kaggle:titanic","eval",8,6,6,1,5,5,0,1,0,0,5,0,1,1,0,0,1,0
"kaggle:titanic","delayedAssign",7,5,4,0,5,4,0,0,0,1,3,2,0,0,0,0,0,0
"kaggle:titanic","sys.parent",1,1,1,0,1,0,0,0,0,1,0,0,0,0,0,0,0,0
"kaggle:titanic","formals",10,3,3,1,2,2,0,1,0,0,1,1,0,0,0,0,0,0
"kaggle:titanic","sys.function",1,1,1,1,0,0,1,0,0,0,0,0,0,0,0,0,0,0
"kaggle:titanic","match.arg",77,53,52,15,38,26,10,5,0,12,32,4,5,0,5,0,0,0
"kaggle:titanic","strsplit",7,6,3,1,5,2,0,1,0,3,5,0,0,0,0,0,0,0
"kaggle:titanic","get0",6,5,5,1,4,4,0,1,0,0,0,4,3,1,2,0,1,0
"kaggle:titanic","getHook",4,4,4,0,4,4,0,0,0,0,2,2,0,0,0,0,0,0
"kaggle:titanic","packageEvent",21,19,13,2,17,8,0,2,0,9,13,1,2,0,2,0,0,0
"kaggle:titanic","match.arg",77,53,52,15,38,26,10,5,0,12,32,4,5,0,5,0,0,0
"kaggle:titanic","isNamespaceLoaded",1,1,1,0,1,1,0,0,0,0,0,1,0,0,0,0,0,0
"kaggle:titanic","setHook",38,19,19,4,15,13,1,3,0,2,11,3,2,1,1,0,1,0
"kaggle:titanic","assign",6,4,4,1,3,3,0,1,0,0,0,3,0,0,0,0,0,0
"kaggle:titanic","which",12,3,2,1,2,1,1,0,0,1,0,1,2,1,1,1,0,0
"kaggle:titanic","NextMethod",4,1,1,0,1,1,0,0,0,0,0,1,1,0,1,0,0,0
"kaggle:titanic","match",4,4,4,2,2,1,0,2,0,1,0,1,1,1,0,0,1,0
"kaggle:titanic","anyDuplicated",1,0,0,0,0,0,0,0,0,0,0,0,0,0,0,0,0,0
"kaggle:titanic","%in%",8,8,8,3,5,2,1,2,0,3,0,2,5,2,3,1,1,0
"kaggle:titanic","vapply",17,11,10,0,11,9,0,0,0,2,4,5,7,0,7,0,0,0
"kaggle:titanic","unique",1,0,0,0,0,0,0,0,0,0,0,0,0,0,0,0,0,0
"kaggle:titanic","setdiff",22,18,18,2,16,15,0,2,0,1,13,2,11,2,9,0,2,0
"kaggle:titanic","as.vector",2,2,2,1,1,0,0,1,0,1,0,0,1,1,0,0,1,0
"kaggle:titanic",".rlang_vctrs_typeof",33,16,11,0,16,2,0,0,0,14,13,1,3,0,3,0,0,0
"kaggle:titanic","accessor",1,1,1,0,1,0,0,0,0,1,0,0,0,0,0,0,0,0
"kaggle:titanic",".row_names_info",2,2,2,0,2,2,0,0,0,0,0,2,0,0,0,0,0,0
"kaggle:titanic","isFALSE",11,8,7,1,7,1,1,0,0,6,6,0,0,0,0,0,0,0
"kaggle:titanic","identical",8,8,8,0,8,2,0,0,0,6,8,0,2,0,2,0,0,0
"kaggle:titanic","integer",1,1,1,0,1,1,0,0,0,0,0,1,1,0,1,0,0,0
"kaggle:titanic","vec_size",16,14,14,6,8,6,5,1,0,2,0,6,5,1,4,0,1,0
"kaggle:titanic","is.data.frame",5,5,5,1,4,2,1,0,0,2,0,2,2,0,2,0,0,0
"kaggle:titanic",".rlang_vctrs_typeof",40,23,15,3,20,10,3,0,0,10,18,1,4,0,4,0,0,0
"kaggle:titanic",".rlang_vctrs_typeof",41,24,24,3,21,12,3,0,0,9,18,2,5,0,5,0,0,0
"kaggle:titanic","",63,20,19,2,18,13,0,2,0,5,13,1,6,0,6,0,0,0
"kaggle:titanic","new_data_frame",37,32,32,9,23,20,8,1,0,3,12,9,10,1,9,0,1,0
"kaggle:titanic","FUN",11,7,7,4,3,2,3,1,0,1,0,2,1,0,1,0,0,0
"kaggle:titanic","unknown--fromConstant",4,1,1,1,0,0,1,0,0,0,0,0,0,0,0,0,0,0
"kaggle:titanic","",10,10,10,1,9,2,1,0,0,7,9,0,2,0,2,0,0,0
"kaggle:titanic",".set_row_names",6,5,5,0,5,4,0,0,0,1,4,1,0,0,0,0,0,0
"kaggle:titanic","vec_is_unspecified",19,6,6,0,6,4,0,0,0,2,2,2,2,0,2,0,0,0
"kaggle:titanic","as.list",1,0,0,0,0,0,0,0,0,0,0,0,0,0,0,0,0,0
"kaggle:titanic","vec_size",16,14,14,6,8,6,5,1,0,2,0,6,5,1,4,0,1,0
"kaggle:titanic","is_function",5,3,3,1,2,2,1,0,0,0,0,2,1,0,1,0,0,0
"kaggle:titanic",".row_names_info",2,2,2,0,2,2,0,0,0,0,0,2,0,0,0,0,0,0
"kaggle:titanic","strrep",10,5,5,1,4,4,1,0,0,0,2,2,1,1,0,1,0,0
"kaggle:titanic","is",124,42,42,13,29,24,7,6,0,5,24,5,10,2,8,0,2,0
"kaggle:titanic","getClassDef",49,10,10,0,10,8,0,0,0,2,4,5,0,0,0,0,0,0
"kaggle:titanic","identical",8,8,8,0,8,2,0,0,0,6,8,0,2,0,2,0,0,0
"kaggle:titanic","getGeneric",132,51,45,11,40,34,6,5,0,6,36,4,5,0,5,0,0,0
"kaggle:titanic","getGeneric",132,51,45,11,40,34,6,5,0,6,36,4,5,0,5,0,0,0
"kaggle:titanic",".getGeneric",50,31,31,5,26,25,3,2,0,1,15,11,8,1,7,1,0,0
"kaggle:titanic",".getGeneric",50,31,31,5,26,25,3,2,0,1,15,11,8,1,7,1,0,0
"kaggle:titanic","match",4,4,4,2,2,0,0,2,0,2,0,0,1,1,0,0,1,0
"kaggle:titanic","environment",1,1,1,0,1,1,0,0,0,0,0,1,1,0,1,0,0,0
"kaggle:titanic","genericForBasic",13,5,5,2,3,3,0,2,0,0,2,1,0,0,0,0,0,0
"kaggle:titanic",".updateMethodsInTable",106,70,69,13,57,47,7,6,0,10,51,4,3,0,3,0,0,0
"kaggle:titanic",".updateMethodsInTable",106,70,69,13,57,47,7,6,0,10,51,4,3,0,3,0,0,0
"kaggle:titanic","exists",8,6,6,1,5,5,0,1,0,0,3,2,1,1,0,0,1,0
"kaggle:titanic","remove",46,29,28,6,23,17,2,4,0,6,14,6,7,0,7,0,0,0
"kaggle:titanic",".resetInheritedMethods",50,27,27,11,16,14,4,7,0,2,15,0,10,2,8,1,1,0
"kaggle:titanic","sapply",32,20,19,4,16,12,4,0,0,4,14,1,0,0,0,0,0,0
"kaggle:titanic","getGroupMembers",38,25,18,3,22,13,2,1,0,9,20,2,2,0,2,0,0,0
"kaggle:titanic",".getGenericFromCacheTable",59,10,10,2,8,7,2,0,0,1,7,1,0,0,0,0,0,0
"kaggle:titanic",".getGeneric",50,31,31,5,26,25,3,2,0,1,15,11,8,1,7,1,0,0
"kaggle:titanic","genericForBasic",13,5,5,2,3,3,0,2,0,0,2,1,0,0,0,0,0,0
"kaggle:titanic","exists",8,6,6,1,5,5,0,1,0,0,3,2,1,1,0,0,1,0
"kaggle:titanic",".recMembers",61,45,44,18,27,22,7,11,0,5,23,2,2,0,2,0,0,0
"kaggle:titanic",".getGenericFromCacheTable",59,10,10,2,8,7,2,0,0,1,7,1,0,0,0,0,0,0
"kaggle:titanic","FUN",10,7,7,3,4,4,1,2,0,0,3,1,0,0,0,0,0,0
"kaggle:titanic","exists",8,6,6,1,5,5,0,1,0,0,3,2,1,1,0,0,1,0
"kaggle:titanic",".getGenericFromCacheTable",59,10,10,2,8,7,2,0,0,1,7,1,0,0,0,0,0,0
"kaggle:titanic","environment",1,1,1,0,1,1,0,0,0,0,0,1,1,0,1,0,0,0
"kaggle:titanic","FUN",13,3,3,1,2,2,1,0,0,0,2,0,0,0,0,0,0,0
"kaggle:titanic","lapply",17,16,15,0,16,14,0,0,0,2,13,1,9,0,9,0,0,0
"kaggle:titanic","is",124,42,42,13,29,24,7,6,0,5,24,5,10,2,8,0,2,0
"kaggle:titanic","getClassDef",49,10,10,0,10,8,0,0,0,2,4,5,0,0,0,0,0,0
"kaggle:titanic","exists",8,6,6,1,5,5,0,1,0,0,3,2,1,1,0,0,1,0
"kaggle:titanic","getGroupMembers",38,25,18,3,22,13,2,1,0,9,20,2,2,0,2,0,0,0
"kaggle:titanic",".getGenericFromCacheTable",59,10,10,2,8,7,2,0,0,1,7,1,0,0,0,0,0,0
"kaggle:titanic","getGeneric",132,51,45,10,41,35,5,5,0,6,37,4,5,0,5,0,0,0
"kaggle:titanic",".getGeneric",50,31,30,5,26,25,3,2,0,1,15,11,8,1,7,1,0,0
"kaggle:titanic",".getGeneric",50,31,30,5,26,25,3,2,0,1,15,11,8,1,7,1,0,0
"kaggle:titanic","exists",8,6,6,1,5,5,0,1,0,0,3,2,1,1,0,0,1,0
"kaggle:titanic",".getGenericFromCacheTable",59,10,10,2,8,7,2,0,0,1,7,1,0,0,0,0,0,0
"kaggle:titanic","parent.frame",1,1,1,0,1,1,0,0,0,0,0,1,1,0,1,0,0,0
"kaggle:titanic","lapply",17,16,15,0,16,14,0,0,0,2,13,1,9,0,9,0,0,0
"kaggle:titanic","environment",1,1,1,0,1,1,0,0,0,0,0,1,1,0,1,0,0,0
"kaggle:titanic","environment",1,1,1,0,1,1,0,0,0,0,0,1,1,0,1,0,0,0
"kaggle:titanic","exists",8,6,6,1,5,5,0,1,0,0,3,2,1,1,0,0,1,0
"kaggle:titanic",".checkGroupSigLength",194,82,82,37,45,35,21,16,0,10,41,4,1,0,1,0,0,0
"kaggle:titanic","getGroupMembers",38,25,18,3,22,13,2,1,0,9,20,2,2,0,2,0,0,0
"kaggle:titanic",".getGenericFromCacheTable",59,10,10,2,8,7,2,0,0,1,7,1,0,0,0,0,0,0
"kaggle:titanic","vector",2,2,2,1,1,1,0,1,0,0,0,1,1,1,0,0,1,0
"kaggle:titanic","setdiff",22,18,18,2,16,14,0,2,0,2,13,2,11,2,9,0,2,0
"kaggle:titanic","exists",8,6,6,1,5,5,0,1,0,0,3,2,1,1,0,0,1,0
"kaggle:titanic",".recMembers",61,45,44,18,27,22,7,11,0,5,23,2,2,0,2,0,0,0
"kaggle:titanic",".getGenericFromCacheTable",59,10,10,2,8,7,2,0,0,1,7,1,0,0,0,0,0,0
"kaggle:titanic","accessor",1,1,1,1,0,0,1,0,0,0,0,0,0,0,0,0,0,0
"kaggle:titanic","environment",1,1,1,0,1,1,0,0,0,0,0,1,1,0,1,0,0,0
"kaggle:titanic","exists",8,6,6,1,5,5,0,1,0,0,3,2,1,1,0,0,1,0
"kaggle:titanic",".checkGroupSigLength",194,82,82,36,46,35,21,15,0,11,42,4,1,0,1,0,0,0
"kaggle:titanic","getGroupMembers",38,25,18,3,22,13,2,1,0,9,20,2,2,0,2,0,0,0
"kaggle:titanic",".getGenericFromCacheTable",59,10,10,2,8,7,2,0,0,1,7,1,0,0,0,0,0,0
"kaggle:titanic","isGroup",7,2,2,1,1,1,1,0,0,0,0,1,0,0,0,0,0,0
"kaggle:titanic","getGeneric",132,51,45,11,40,34,6,5,0,6,36,4,5,0,5,0,0,0
"kaggle:titanic","exists",8,6,6,1,5,5,0,1,0,0,3,2,1,1,0,0,1,0
"kaggle:titanic","cacheGenericsMetaData",108,54,54,7,47,41,6,1,0,6,34,11,8,1,7,0,1,0
"kaggle:titanic",".getGenericFromCacheTable",59,10,10,2,8,7,2,0,0,1,7,1,0,0,0,0,0,0
"kaggle:titanic","",27,4,4,1,3,1,0,1,0,2,1,1,2,1,1,0,1,0
"kaggle:titanic","dispatchIsInternal",11,7,7,1,6,4,1,0,0,2,1,4,3,0,3,0,0,0
"kaggle:titanic",".cacheGeneric",68,23,17,4,19,13,2,2,0,6,17,2,2,0,2,0,0,0
"kaggle:titanic","setPrimitiveMethods",16,7,7,0,7,7,0,0,0,0,3,4,0,0,0,0,0,0
"kaggle:titanic",".getMethodsTable",14,10,9,1,9,7,1,0,0,2,8,1,0,0,0,0,0,0
"kaggle:titanic","find.package",310,87,87,32,55,49,17,15,0,6,43,11,17,5,12,2,3,0
"kaggle:titanic","tryCatch",53,26,26,7,19,16,3,4,0,3,15,4,4,0,4,0,0,0
"kaggle:titanic","do.call",9,6,6,1,5,5,0,1,0,0,3,2,3,1,2,0,1,0
"kaggle:titanic","grepl",56,16,16,3,13,11,2,1,0,2,9,2,2,0,2,0,0,0
"kaggle:titanic","ncol",4,3,3,1,2,2,1,0,0,0,0,2,0,0,0,0,0,0
"kaggle:titanic","methodsPackageMetaName",9,5,5,0,5,5,0,0,0,0,4,1,0,0,0,0,0,0
"kaggle:titanic","Sys.getenv",59,19,18,6,13,7,4,2,0,6,11,0,1,0,1,0,0,0
"kaggle:titanic","classMetaName",11,7,7,0,7,7,0,0,0,0,6,1,0,0,0,0,0,0
"kaggle:titanic","getGeneric",132,51,45,10,41,35,5,5,0,6,37,4,5,0,5,0,0,0
"kaggle:titanic",".getGeneric",50,31,30,5,26,25,3,2,0,1,15,11,8,1,7,1,0,0
"kaggle:titanic","exists",8,6,6,1,5,5,0,1,0,0,3,2,1,1,0,0,1,0
"kaggle:titanic",".getGenericFromCacheTable",59,10,10,2,8,7,2,0,0,1,7,1,0,0,0,0,0,0
"kaggle:titanic","lengths",2,2,2,1,1,1,0,1,0,0,0,1,1,1,0,0,1,0
"kaggle:titanic","simplify2array",151,23,22,8,15,10,5,3,0,5,14,1,2,0,2,0,0,0
"kaggle:titanic","character",1,1,1,0,1,1,0,0,0,0,0,1,0,0,0,0,0,0
"kaggle:titanic","FUN",36,15,15,2,13,13,1,1,0,0,8,5,1,0,1,0,0,0
"kaggle:titanic","tryCatch",53,26,26,7,19,16,3,4,0,3,15,4,4,0,4,0,0,0
"kaggle:titanic","aperm",1,0,0,0,0,0,0,0,0,0,0,0,0,0,0,0,0,0
"kaggle:titanic","apply",375,126,121,48,78,41,39,9,0,37,73,1,4,0,4,0,0,0
"kaggle:titanic","normalizePath",5,5,5,0,5,5,0,0,0,0,3,2,0,0,0,0,0,0
"kaggle:titanic","matrix",13,9,6,0,9,4,0,0,0,5,8,0,2,0,2,0,0,0
"kaggle:titanic","strsplit",7,6,3,2,4,1,0,2,0,3,4,0,0,0,0,0,0,0
"kaggle:titanic","nchar",4,4,4,1,3,0,0,1,0,3,2,0,1,1,0,0,1,0
"kaggle:titanic","vapply",17,11,10,0,11,9,0,0,0,2,4,5,7,0,7,0,0,0
"kaggle:titanic","list2env",2,2,2,1,1,1,0,1,0,0,0,1,0,0,0,0,0,0
"kaggle:titanic","nrow",4,3,3,1,2,2,1,0,0,0,0,2,1,0,1,0,0,0
"kaggle:titanic","lockEnvironment",2,2,2,1,1,1,0,1,0,0,0,1,1,1,0,0,1,0
"kaggle:titanic","packageEvent",21,19,13,1,18,9,0,1,0,9,12,3,4,0,4,0,0,0
"kaggle:titanic","tryCatch",53,26,26,7,19,16,3,4,0,3,15,4,4,0,4,0,0,0
"kaggle:titanic","try",4,2,2,0,2,2,0,0,0,0,2,0,2,0,2,0,0,0
"kaggle:titanic","do.call",9,6,6,1,5,5,0,1,0,0,3,2,3,1,2,0,1,0
"kaggle:titanic",".make_numeric_version",51,32,31,11,21,18,4,6,1,3,17,3,6,3,3,0,2,1
"kaggle:titanic","which",12,3,2,1,2,1,1,0,0,1,0,1,2,1,1,1,0,0
"kaggle:titanic","NextMethod",4,1,1,0,1,1,0,0,0,0,0,1,1,0,1,0,0,0
"kaggle:titanic","split",1,0,0,0,0,0,0,0,0,0,0,0,0,0,0,0,0,0
"kaggle:titanic",".encode_numeric_version",158,92,87,12,80,67,7,5,0,13,61,12,43,4,39,1,3,0
"kaggle:titanic","ifelse",105,31,31,15,16,10,11,4,0,6,12,2,18,9,9,7,2,0
"kaggle:titanic","sort.int",239,13,11,1,12,7,1,0,0,5,12,0,0,0,0,0,0,0
"kaggle:titanic","makeImportExportNames",20,9,9,3,6,5,0,3,0,1,5,1,0,0,0,0,0,0
"kaggle:titanic","namespaceIsSealed",3,3,3,1,2,2,1,0,0,0,0,2,0,0,0,0,0,0
"kaggle:titanic","whichMethodMetaNames",12,8,8,3,5,4,3,0,0,1,3,1,0,0,0,0,0,0
"kaggle:titanic","asNamespace",33,27,20,5,22,14,4,1,0,8,19,3,3,1,2,0,1,0
"kaggle:titanic","importIntoEnv",90,33,33,3,30,28,2,1,0,2,22,8,7,1,6,1,0,0
"kaggle:titanic","addImports",96,63,52,16,47,35,7,9,0,12,41,4,13,3,10,1,2,0
"kaggle:titanic","new.env",4,4,4,2,2,1,1,1,0,1,0,1,1,1,0,0,1,0
"kaggle:titanic","mkenv",1,1,1,1,0,0,0,1,0,0,0,0,0,0,0,0,0,0
"kaggle:titanic","as.name",1,1,1,0,1,1,0,0,0,0,0,1,0,0,0,0,0,0
"kaggle:titanic","lazyLoadDBexec",46,36,34,7,29,25,3,4,0,4,24,3,0,0,0,0,0,0
"kaggle:titanic","readRDS",11,8,8,0,8,7,0,0,0,1,6,2,0,0,0,0,0,0
"kaggle:titanic","close",1,1,1,0,1,1,0,0,0,0,0,1,0,0,0,0,0,0
"kaggle:titanic","environment",0,0,0,0,0,0,0,0,0,0,0,0,0,0,0,0,0,0
"kaggle:titanic",".dynLibs",4,2,2,0,2,2,0,0,0,0,2,0,0,0,0,0,0,0
"kaggle:titanic","FUN",6,2,2,0,2,2,0,0,0,0,0,2,0,0,0,0,0,0
"kaggle:titanic","tolower",7,3,3,1,2,2,0,1,0,0,1,1,2,1,1,0,1,0
"kaggle:titanic","pmatch",8,6,6,2,4,2,0,2,0,2,2,0,0,0,0,0,0,0
"kaggle:titanic","vector",2,2,2,0,2,2,0,0,0,0,0,2,1,0,1,0,0,0
"kaggle:titanic","unlist",27,5,5,1,4,4,0,1,0,0,4,0,2,1,1,0,1,0
"kaggle:titanic","rm",46,35,34,7,28,22,3,4,0,6,19,6,13,2,11,0,2,0
"kaggle:titanic","",113,64,62,9,55,46,9,0,0,9,50,3,0,0,0,0,0,0
"kaggle:titanic","regularize.values",152,50,48,16,34,20,14,2,0,14,34,0,2,0,2,0,0,0
"kaggle:titanic","fx",10,6,6,0,6,6,0,0,0,0,5,1,5,0,5,0,0,0
"kaggle:titanic","unknown--fromConstant",45,18,18,4,14,12,2,2,0,2,10,2,5,0,5,0,0,0
"kaggle:titanic","is.logint",9,6,5,0,6,1,0,0,0,5,3,1,1,0,1,0,0,0
"kaggle:titanic","lintrj",7,7,7,1,6,5,1,0,0,1,6,0,0,0,0,0,0,0
"kaggle:titanic","colour_ramp",101,53,52,9,44,43,7,2,0,1,34,9,3,0,3,0,0,0
"kaggle:titanic","",107,45,44,10,35,26,6,4,0,9,26,7,3,0,3,0,0,0
"kaggle:titanic","as_white_ref",129,59,57,15,44,34,7,8,0,10,41,3,6,2,4,0,2,0
"kaggle:titanic","colnames<-",38,28,27,8,20,14,5,3,0,6,12,4,3,0,3,0,0,0
"kaggle:titanic","unknown--fromOverride",489,69,66,18,51,33,15,3,0,18,46,1,2,1,1,0,1,0
"kaggle:titanic","",409,109,109,12,97,86,8,4,0,11,90,6,4,0,4,0,0,0
"kaggle:titanic","rownames",17,6,6,1,5,2,0,1,0,3,4,1,0,0,0,0,0,0
"kaggle:titanic","hcl",13,7,7,0,7,7,0,0,0,0,3,4,2,0,2,0,0,0
"kaggle:titanic","colourspace_match",23,16,16,3,13,9,1,2,0,4,8,3,2,0,2,0,0,0
"kaggle:titanic","chkDots",15,1,1,1,0,0,1,0,0,0,0,0,0,0,0,0,0,0
"kaggle:titanic","lintrj",7,7,7,3,4,3,3,0,0,1,4,0,0,0,0,0,0,0
"kaggle:titanic","seqhcl",66,53,53,4,49,46,3,1,0,3,43,6,2,0,2,0,0,0
"kaggle:titanic","lintrj",7,7,7,3,4,3,3,0,0,1,4,0,0,0,0,0,0,0
"kaggle:titanic","tritrj",26,26,26,0,26,26,0,0,0,0,25,1,0,0,0,0,0,0
"kaggle:titanic","ifelse",105,36,35,18,18,11,13,5,0,7,13,3,20,11,9,6,5,0
"kaggle:titanic","charmatch",7,5,5,2,3,3,0,2,0,0,2,1,0,0,0,0,0,0
"kaggle:titanic","seqhcl",66,53,53,4,49,46,3,1,0,3,43,6,2,0,2,0,0,0
"kaggle:titanic","rev",1,0,0,0,0,0,0,0,0,0,0,0,0,0,0,0,0,0
"kaggle:titanic","",409,168,168,20,148,132,13,7,0,16,141,6,4,0,4,0,0,0
"kaggle:titanic","rev",1,0,0,0,0,0,0,0,0,0,0,0,0,0,0,0,0,0
"kaggle:titanic","",396,234,234,29,205,186,19,10,0,19,202,2,2,0,2,0,0,0
"kaggle:titanic","rev",1,0,0,0,0,0,0,0,0,0,0,0,0,0,0,0,0,0
"kaggle:titanic","",396,234,234,29,205,186,19,10,0,19,202,2,2,0,2,0,0,0
"kaggle:titanic","check_function",20,6,6,2,4,3,2,0,0,1,0,3,1,0,1,0,0,0
"kaggle:titanic","fx",10,6,6,0,6,6,0,0,0,0,5,1,5,0,5,0,0,0
"kaggle:titanic","palette.match",13,11,11,3,8,7,1,2,0,1,6,1,0,0,0,0,0,0
"kaggle:titanic","bindTranslations",27,26,26,4,22,22,3,1,0,0,16,6,5,1,4,1,0,0
"kaggle:titanic","dirname",1,1,1,0,1,1,0,0,0,0,0,1,0,0,0,0,0,0
"kaggle:titanic","basename",1,1,1,0,1,1,0,0,0,0,0,1,0,0,0,0,0,0
"kaggle:titanic","packageHasNamespace",5,5,5,1,4,4,1,0,0,0,3,1,1,0,1,0,0,0
"kaggle:titanic","dir.exists",1,1,1,1,0,0,0,1,0,0,0,0,0,0,0,0,0,0
"kaggle:titanic","makeNamespace",70,52,46,13,39,32,1,12,0,7,31,3,2,2,0,1,1,0
"kaggle:titanic","asNamespace",33,27,20,4,23,15,4,0,0,8,19,4,3,0,3,0,0,0
"kaggle:titanic","file",8,8,8,0,8,7,0,0,0,1,8,0,0,0,0,0,0,0
"kaggle:titanic","environment",1,1,1,0,1,1,0,0,0,0,0,1,1,0,1,0,0,0
"kaggle:titanic","get0",6,5,5,1,4,4,0,1,0,0,0,4,3,1,2,0,1,0
"kaggle:titanic","asNamespace",33,27,20,4,23,15,4,0,0,8,19,4,3,0,3,0,0,0
"kaggle:titanic","registerS3methods",410,218,204,52,166,138,29,23,0,28,143,16,18,3,15,2,1,0
"kaggle:titanic","setHook",38,19,19,4,15,13,1,3,0,2,11,3,2,1,1,0,1,0
"kaggle:titanic","assign",6,4,4,1,3,3,0,1,0,0,0,3,1,0,1,0,0,0
"kaggle:titanic","registerS3method",81,51,51,9,42,35,6,3,0,7,36,5,11,1,10,1,0,0
"kaggle:titanic","addNamespaceDynLibs",19,18,17,6,12,9,1,5,0,3,10,1,5,1,4,1,0,0
"kaggle:titanic","runHook",24,12,10,3,9,6,2,1,0,3,3,3,5,1,4,1,0,0
"kaggle:titanic","%in%",4,4,4,1,3,3,1,0,0,0,2,1,4,1,3,1,0,0
"kaggle:titanic","match",4,4,4,2,2,1,0,2,0,1,0,1,2,2,0,0,2,0
"kaggle:titanic","%in%",4,4,4,1,3,3,1,0,0,0,2,1,4,1,3,1,0,0
"kaggle:titanic","chr",7,4,4,0,4,4,0,0,0,0,0,4,0,0,0,0,0,0
"kaggle:titanic","dots_values",13,7,7,0,7,7,0,0,0,0,4,3,0,0,0,0,0,0
"kaggle:titanic","",20,13,13,3,10,9,3,0,0,1,7,2,0,0,0,0,0,0
"kaggle:titanic","parent.env",1,1,1,1,0,0,0,1,0,0,0,0,0,0,0,0,0,0
"kaggle:titanic","parent.env",1,1,1,1,0,0,0,1,0,0,0,0,0,0,0,0,0,0
"kaggle:titanic","namespaceExport",124,74,71,19,55,45,9,10,0,10,42,10,12,1,11,1,0,0
"kaggle:titanic","list2env",14,3,3,1,2,2,0,1,0,0,1,1,0,0,0,0,0,0
"kaggle:titanic",".mergeExportMethods",41,9,8,3,6,5,1,2,0,1,2,3,0,0,0,0,0,0
"kaggle:titanic","sealNamespace",15,11,11,2,9,9,2,0,0,0,5,4,0,0,0,0,0,0
"kaggle:titanic","lockEnvironment",2,2,2,1,1,1,0,1,0,0,0,1,1,1,0,0,1,0
"kaggle:titanic","runUserHook",18,11,11,0,11,10,0,0,0,1,8,3,2,0,2,0,0,0
"kaggle:titanic","Sys.unsetenv",3,2,2,0,2,2,0,0,0,0,2,0,0,0,0,0,0,0
"kaggle:titanic","getNamespaceExports",29,22,22,4,18,10,2,2,0,8,15,2,3,0,3,0,0,0
"kaggle:titanic","parent.frame",1,1,1,1,0,0,0,1,0,0,0,0,1,1,0,0,1,0
"kaggle:titanic","dynGet",104,66,64,17,49,43,11,6,0,6,48,1,11,3,8,0,3,0
"kaggle:titanic","lazyLoadDBexec",46,36,31,7,29,25,3,4,0,4,24,3,0,0,0,0,0,0
"kaggle:titanic","lazyLoad",5,4,4,0,4,4,0,0,0,0,2,2,0,0,0,0,0,0
"kaggle:titanic","fun",11,9,9,1,8,6,0,1,0,2,7,0,0,0,0,0,0,0
"kaggle:titanic","FUN",2,2,2,0,2,2,0,0,0,0,0,2,0,0,0,0,0,0
"kaggle:titanic","delayedAssign",7,5,4,1,4,3,0,1,0,1,3,1,0,0,0,0,0,0
"kaggle:titanic","typeof",1,1,1,1,0,0,1,0,0,0,0,0,1,1,0,1,0,0
"kaggle:titanic","is.primitive",3,3,3,0,3,2,0,0,0,1,0,2,2,0,2,0,0,0
"kaggle:titanic","identical",8,8,8,0,8,8,0,0,0,0,8,0,2,0,2,0,0,0
"kaggle:titanic",".libPaths",22,1,1,1,0,0,0,1,0,0,0,0,0,0,0,0,0,0
"kaggle:titanic","getNamespaceVersion",38,22,22,5,17,10,2,3,0,7,14,2,3,0,3,0,0,0
"kaggle:titanic","",91,28,16,11,17,7,6,5,0,10,12,3,1,0,1,0,0,0
"kaggle:titanic","%||%",3,2,2,2,0,0,0,2,0,0,0,0,0,0,0,0,0,0
"kaggle:titanic","ansi_style_str",5,5,3,0,5,3,0,0,0,2,0,3,1,0,1,0,0,0
"kaggle:titanic","as.list",1,0,0,0,0,0,0,0,0,0,0,0,0,0,0,0,0,0
"kaggle:titanic","get_handlers",3,2,2,0,2,2,0,0,0,0,0,2,2,0,2,0,0,0
"kaggle:titanic","is_builtin_style",20,17,17,6,11,9,4,2,0,2,8,3,4,1,3,1,0,0
"kaggle:titanic","eval",8,7,7,1,6,6,0,1,0,0,6,0,1,1,0,0,1,0
"kaggle:titanic","create_ansi_style",94,57,55,9,48,44,4,5,0,4,41,6,12,2,10,0,2,0
"kaggle:titanic","create_ansi_style_fun",10,5,5,0,5,5,0,0,0,0,2,3,0,0,0,0,0,0
"kaggle:titanic","",40,24,22,5,19,15,5,0,0,4,10,9,4,1,3,1,0,0
"kaggle:titanic","l10n_info",0,0,0,0,0,0,0,0,0,0,0,0,0,0,0,0,0,0
"kaggle:titanic","loadedNamespaces",1,1,1,0,1,1,0,0,0,0,0,1,0,0,0,0,0,0
"kaggle:titanic","topenv",4,3,3,1,2,2,0,1,0,0,2,0,0,0,0,0,0,0
"kaggle:titanic","addNamespaceS3method",20,18,17,4,14,13,1,3,0,1,11,3,3,1,2,1,0,0
"kaggle:titanic","registerS3method",81,51,51,9,42,35,6,3,0,7,38,3,11,1,10,1,0,0
"kaggle:titanic","FUN",11,7,7,5,2,2,3,2,0,0,1,1,1,0,1,0,0,0
"kaggle:titanic",".make_numeric_version",50,31,28,12,19,17,4,7,1,2,16,3,6,4,2,0,3,1
"kaggle:titanic",".make_numeric_version",50,31,28,12,19,17,4,7,1,2,16,3,6,4,2,0,3,1
"kaggle:titanic","package_version",33,24,24,2,22,22,2,0,0,0,15,7,5,1,4,1,0,0
"kaggle:titanic","",72,26,25,4,22,14,2,2,0,8,18,1,4,0,4,0,0,0
"kaggle:titanic","getGeneric",68,32,29,6,26,21,3,3,0,5,22,4,3,0,3,0,0,0
"kaggle:titanic",".getGeneric",50,31,30,5,26,25,3,2,0,1,17,9,8,1,7,1,0,0
"kaggle:titanic","exists",8,6,6,1,5,5,0,1,0,0,3,2,1,1,0,0,1,0
"kaggle:titanic",".cacheGenericTable",64,24,24,4,20,14,2,2,0,6,20,0,2,0,2,0,0,0
"kaggle:titanic",".getMethodsTable",14,10,9,1,9,7,1,0,0,2,8,1,0,0,0,0,0,0
"kaggle:titanic",".getGenericFromCacheTable",59,10,10,2,8,7,2,0,0,1,7,1,0,0,0,0,0,0
"kaggle:titanic","getGeneric",68,32,32,7,25,25,4,3,0,0,21,4,3,0,3,0,0,0
"kaggle:titanic","exists",8,6,6,1,5,5,0,1,0,0,3,2,1,1,0,0,1,0
"kaggle:titanic",".cacheGenericTable",64,24,24,4,20,14,2,2,0,6,20,0,2,0,2,0,0,0
"kaggle:titanic",".getMethodsTable",14,10,9,1,9,7,1,0,0,2,8,1,0,0,0,0,0,0
"kaggle:titanic",".getGenericFromCacheTable",59,10,10,2,8,7,2,0,0,1,7,1,0,0,0,0,0,0
"kaggle:titanic","do.call",9,6,6,1,5,5,0,1,0,0,3,2,3,1,2,0,1,0
"kaggle:titanic","exists",8,6,6,1,5,5,0,1,0,0,3,2,1,1,0,0,1,0
"kaggle:titanic","environmentIsLocked",1,1,1,1,0,0,0,1,0,0,0,0,0,0,0,0,0,0
"kaggle:titanic","FUN",0,0,0,0,0,0,0,0,0,0,0,0,0,0,0,0,0,0
"kaggle:titanic","FUN",26,12,12,2,10,4,2,0,0,6,6,2,1,0,1,0,0,0
"kaggle:titanic","is_theme_element",18,9,9,1,8,2,1,0,0,6,4,2,1,0,1,0,0,0
"kaggle:titanic","%||%",3,2,2,0,2,1,0,0,0,1,2,0,0,0,0,0,0,0
"kaggle:titanic","is_theme_element",18,11,11,2,9,5,2,0,0,4,4,3,1,0,1,0,0,0
"kaggle:titanic","FUN",23,14,10,3,11,5,3,0,0,6,6,2,1,0,1,0,0,0
"kaggle:titanic","matrix",13,9,6,0,9,4,0,0,0,5,8,0,2,0,2,0,0,0
"kaggle:titanic","caller_env",3,3,3,0,3,3,0,0,0,0,2,1,0,0,0,0,0,0
"kaggle:titanic",".cacheClass",74,42,35,6,36,22,4,2,0,14,31,4,3,0,3,0,0,0
"kaggle:titanic","duplicated",1,0,0,0,0,0,0,0,0,0,0,0,0,0,0,0,0,0
"kaggle:titanic","grep",95,19,19,3,16,14,2,1,0,2,12,2,2,0,2,0,0,0
"kaggle:titanic","substring",36,18,18,8,10,4,4,4,0,6,10,0,0,0,0,0,0,0
"kaggle:titanic","",49,16,14,0,16,14,0,0,0,2,12,2,1,0,1,0,0,0
"kaggle:titanic","exists",8,6,6,1,5,5,0,1,0,0,3,2,1,1,0,0,1,0
"kaggle:titanic","setHook",38,19,19,4,15,13,1,3,0,2,11,3,2,1,1,0,1,0
"kaggle:titanic","s3_register",50,49,46,6,43,28,4,2,0,15,38,4,2,0,2,0,0,0
"kaggle:titanic","exists",8,6,6,1,5,5,0,1,0,0,3,2,1,1,0,0,1,0
"kaggle:titanic","register",31,21,21,1,20,19,1,0,0,1,16,4,2,0,2,0,0,0
"kaggle:titanic","is_namespace",3,3,3,1,2,2,1,0,0,0,0,2,0,0,0,0,0,0
"kaggle:titanic","ns_env",28,20,19,5,15,13,4,1,0,2,8,6,3,0,3,0,0,0
"kaggle:titanic","check_environment",19,7,7,1,6,3,0,1,0,3,0,3,1,0,1,0,0,0
"kaggle:titanic","get0",6,5,5,0,5,4,0,0,0,1,0,4,3,0,3,0,0,0
"kaggle:titanic","get0",6,5,5,1,4,4,0,1,0,0,0,4,3,1,2,0,1,0
"kaggle:titanic","",53,10,9,2,8,6,2,0,0,2,6,2,0,0,0,0,0,0
"kaggle:titanic","getFunction",43,13,11,5,8,7,3,2,0,1,8,0,0,0,0,0,0,0
"kaggle:titanic","isBaseFun",16,16,9,2,14,7,1,1,0,7,12,2,3,0,3,0,0,0
"kaggle:titanic","get",6,6,6,0,6,6,0,0,0,0,3,3,1,0,1,0,0,0
"kaggle:titanic","",57,20,19,5,15,12,4,1,0,3,13,2,4,1,3,1,0,0
"kaggle:titanic","environment",1,1,1,0,1,1,0,0,0,0,0,1,1,0,1,0,0,0
"kaggle:titanic","get0",6,5,5,1,4,4,0,1,0,0,0,4,3,1,2,0,1,0
"kaggle:titanic","asNamespace",33,27,20,4,23,15,4,0,0,8,19,4,3,0,3,0,0,0
"kaggle:titanic","registerS3methods",395,203,189,51,152,124,28,23,0,28,135,10,18,3,15,2,1,0
"kaggle:titanic","library.dynam",168,74,72,13,61,55,10,3,0,6,48,11,12,1,11,1,0,0
"kaggle:titanic","assignNativeRoutines",47,35,34,7,28,23,4,3,0,5,22,3,4,2,2,0,2,0
"kaggle:titanic","runUserHook",18,12,12,0,12,11,0,0,0,1,8,4,3,0,3,0,0,0
"kaggle:titanic","isFALSE",11,8,7,5,3,1,4,1,0,2,2,0,1,1,0,0,1,0
"kaggle:titanic",".make_numeric_version",50,31,28,12,19,17,4,7,1,2,16,3,6,4,2,0,3,1
"kaggle:titanic","getRversion",35,26,26,2,24,24,2,0,0,0,15,9,5,1,4,1,0,0
"kaggle:titanic","search",0,0,0,0,0,0,0,0,0,0,0,0,0,0,0,0,0,0
"kaggle:titanic","TRAFO",1,1,1,1,0,0,0,1,0,0,0,0,0,0,0,0,0,0
"kaggle:titanic","get",6,6,6,0,6,6,0,0,0,0,2,4,4,0,4,0,0,0
"kaggle:titanic","FUN",9,9,9,1,8,8,1,0,0,0,8,0,4,0,4,0,0,0
"kaggle:titanic","TRAFO",1,1,1,0,1,1,0,0,0,0,0,1,1,0,1,0,0,0
"kaggle:titanic","strrep",10,5,5,0,5,4,0,0,0,1,2,2,1,0,1,0,0,0
"kaggle:titanic","nchar",4,4,4,1,3,1,0,1,0,2,2,1,1,0,1,0,0,0
"kaggle:titanic",".mergeImportMethods",19,5,5,1,4,2,0,1,0,2,3,1,0,0,0,0,0,0
"kaggle:titanic","",81,46,46,19,27,23,7,12,0,4,22,5,1,0,1,0,0,0
"kaggle:titanic","get",6,6,6,1,5,5,0,1,0,0,2,3,4,1,3,0,1,0
"kaggle:titanic",".cacheClass",74,44,37,6,38,24,4,2,0,14,31,5,5,0,5,0,0,0
"kaggle:titanic","get0",6,5,5,1,4,4,0,1,0,0,0,4,3,1,2,0,1,0
"kaggle:titanic","getClassDef",60,38,38,1,37,35,1,0,0,2,30,7,5,0,5,0,0,0
"kaggle:titanic","getNamespace",5,3,3,0,3,2,0,0,0,1,2,1,0,0,0,0,0,0
"kaggle:titanic","get0",6,5,5,1,4,4,0,1,0,0,0,4,3,1,2,0,1,0
"kaggle:titanic","getClassDef",60,38,36,1,37,33,1,0,0,4,30,7,5,0,5,0,0,0
"kaggle:titanic","FUN",25,14,13,1,13,3,1,0,0,10,9,2,1,0,1,0,0,0
"kaggle:titanic",".identC",7,4,4,1,3,3,1,0,0,0,0,3,1,0,1,0,0,0
"kaggle:titanic","isBaseFun",17,17,17,1,16,8,1,0,0,8,13,2,6,0,6,0,0,0
"kaggle:titanic","unknown--fromConstant",9,3,3,0,3,2,0,0,0,1,2,1,0,0,0,0,0,0
"kaggle:titanic","isTRUE",11,8,7,3,5,2,3,0,0,3,3,1,1,0,1,0,0,0
"kaggle:titanic","get0",6,5,5,1,4,4,0,1,0,0,0,4,3,1,2,0,1,0
"kaggle:titanic","getClassDef",60,38,36,1,37,33,1,0,0,4,30,7,5,0,5,0,0,0
"kaggle:titanic",".requirePackage",43,12,11,3,9,7,1,2,0,2,8,1,0,0,0,0,0,0
"kaggle:titanic","getClass",16,4,4,0,4,2,0,0,0,2,3,1,1,0,1,0,0,0
"kaggle:titanic","packageSlot",3,2,2,0,2,2,0,0,0,0,0,2,2,0,2,0,0,0
"kaggle:titanic","typeof",1,1,1,0,1,1,0,0,0,0,0,1,1,0,1,0,0,0
"kaggle:titanic","",13,9,9,0,9,9,0,0,0,0,7,2,0,0,0,0,0,0
"kaggle:titanic","formals",10,3,3,0,3,2,0,0,0,1,2,1,2,0,2,0,0,0
"kaggle:titanic","formals",10,3,2,0,3,2,0,0,0,1,2,1,2,0,2,0,0,0
"kaggle:titanic","formalArgs",7,3,3,1,2,2,0,1,0,0,0,2,1,0,1,0,0,0
"kaggle:titanic","as.name",1,1,1,1,0,0,0,1,0,0,0,0,0,0,0,0,0,0
"kaggle:titanic","is.primitive",3,3,3,0,3,2,0,0,0,1,0,2,2,0,2,0,0,0
"kaggle:titanic","isFALSE",11,8,3,4,4,2,4,0,0,2,2,1,1,0,1,0,0,0
"kaggle:titanic","cacheGenericsMetaData",108,54,54,7,47,41,7,0,0,6,35,10,10,0,10,0,0,0
"kaggle:titanic",".getMethodsTable",14,10,9,1,9,7,1,0,0,2,8,1,0,0,0,0,0,0
"kaggle:titanic",".sigLabel",6,6,3,0,6,3,0,0,0,3,0,3,3,0,3,0,0,0
"kaggle:titanic","getGeneric",68,32,32,6,26,26,3,3,0,0,22,4,3,0,3,0,0,0
"kaggle:titanic","isFALSE",11,8,3,4,4,2,4,0,0,2,2,1,1,0,1,0,0,0
"kaggle:titanic","isFALSE",11,8,3,4,4,2,4,0,0,2,2,1,1,0,1,0,0,0
"kaggle:titanic",".getGeneric",50,31,30,5,26,25,3,2,0,1,17,9,9,1,8,1,0,0
"kaggle:titanic",".getGeneric",50,31,30,5,26,25,3,2,0,1,17,9,9,1,8,1,0,0
"kaggle:titanic","environment",1,1,1,0,1,1,0,0,0,0,0,1,1,0,1,0,0,0
"kaggle:titanic","isTRUE",11,8,3,3,5,2,3,0,0,3,3,1,1,0,1,0,0,0
"kaggle:titanic","get0",6,5,5,1,4,4,0,1,0,0,0,4,3,1,2,0,1,0
"kaggle:titanic","exists",8,6,6,0,6,6,0,0,0,0,2,4,4,0,4,0,0,0
"kaggle:titanic","exists",8,6,6,0,6,6,0,0,0,0,2,4,4,0,4,0,0,0
"kaggle:titanic",".getMethodsTable",14,10,9,1,9,7,1,0,0,2,8,1,0,0,0,0,0,0
"kaggle:titanic",".getMethodsTable",14,10,10,3,7,7,3,0,0,0,6,1,0,0,0,0,0,0
"kaggle:titanic","as",178,88,84,15,73,63,10,5,0,10,63,10,10,0,10,0,0,0
"kaggle:titanic","getClass",16,4,2,0,4,2,0,0,0,2,3,1,1,0,1,0,0,0
"kaggle:titanic","new",11,7,7,0,7,7,0,0,0,0,5,2,3,0,3,0,0,0
"kaggle:titanic","formalArgs",7,3,3,1,2,2,0,1,0,0,0,2,1,0,1,0,0,0
"kaggle:titanic",".matchSigLength",93,20,14,6,14,10,4,2,0,4,10,3,3,0,3,0,0,0
"kaggle:titanic",".matchSigLength",93,20,20,6,14,10,4,2,0,4,10,3,3,0,3,0,0,0
"kaggle:titanic",".findMethodInTable",39,21,18,3,18,12,1,2,0,6,12,3,6,0,6,0,0,0
"kaggle:titanic",".getGenericSigLength",8,5,5,2,3,3,2,0,0,0,3,0,0,0,0,0,0,0
"kaggle:titanic",".getGenericSigLength",8,5,5,2,3,3,2,0,0,0,3,0,0,0,0,0,0,0
"kaggle:titanic",".classEnv",38,9,9,1,8,7,0,1,0,1,4,4,2,0,2,0,0,0
"kaggle:titanic","body<-",3,1,1,0,1,1,0,0,0,0,0,1,1,0,1,0,0,0
"kaggle:titanic",".duplicateClassesExist",6,4,4,1,3,1,1,0,0,2,1,1,0,0,0,0,0,0
"kaggle:titanic",".cacheMethodInTable",113,28,25,2,26,22,2,0,0,4,17,6,3,0,3,0,0,0
"kaggle:titanic","FUN",7,3,3,2,1,1,2,0,0,0,0,1,0,0,0,0,0,0
"kaggle:titanic","mget",7,5,5,1,4,4,0,1,0,0,0,4,0,0,0,0,0,0
"kaggle:titanic","packageSlot<-",3,3,3,0,3,3,0,0,0,0,2,1,1,0,1,0,0,0
"kaggle:titanic",".identC",7,4,4,1,3,3,1,0,0,0,2,1,2,0,2,0,0,0
"kaggle:titanic",".cacheGenericTable",64,24,24,4,20,14,2,2,0,6,20,0,2,0,2,0,0,0
"kaggle:titanic",".getMethodsTable",14,10,9,1,9,7,1,0,0,2,8,1,0,0,0,0,0,0
"kaggle:titanic",".resetInheritedMethods",54,38,36,11,27,22,4,7,0,5,22,1,16,4,12,1,3,0
"kaggle:titanic","assign",6,6,6,0,6,6,0,0,0,0,3,3,1,0,1,0,0,0
"kaggle:titanic","isFALSE",11,8,3,4,4,2,4,0,0,2,2,1,1,0,1,0,0,0
"kaggle:titanic","environment",1,1,1,0,1,1,0,0,0,0,0,1,1,0,1,0,0,0
"kaggle:titanic",".updateMethodsInTable",106,74,73,13,61,51,7,6,0,10,55,4,4,0,4,0,0,0
"kaggle:titanic",".updateMethodsInTable",106,74,73,13,61,51,7,6,0,10,55,4,4,0,4,0,0,0
"kaggle:titanic",".resetInheritedMethods",54,38,36,12,26,21,4,8,0,5,21,1,16,4,12,1,3,0
"kaggle:titanic","assign",6,6,6,0,6,6,0,0,0,0,3,3,1,0,1,0,0,0
"kaggle:titanic",".getMethodsTable",14,10,9,1,9,7,1,0,0,2,8,1,0,0,0,0,0,0
"kaggle:titanic","",27,4,4,1,3,3,1,0,0,0,2,1,2,0,2,0,0,0
"kaggle:titanic","dispatchIsInternal",11,7,7,1,6,4,1,0,0,2,1,4,4,0,4,0,0,0
"kaggle:titanic",".cacheGeneric",4,4,4,0,4,4,0,0,0,0,2,2,0,0,0,0,0,0
"kaggle:titanic",".cacheGenericTable",64,24,18,4,20,14,2,2,0,6,20,0,2,0,2,0,0,0
"kaggle:titanic",".getMethodsTable",14,10,9,1,9,7,1,0,0,2,8,1,0,0,0,0,0,0
"kaggle:titanic","is.primitive",3,3,3,0,3,2,0,0,0,1,0,2,2,0,2,0,0,0
"kaggle:titanic","logical",1,1,1,0,1,1,0,0,0,0,0,1,1,0,1,0,0,0
"kaggle:titanic","lastEnv",13,13,13,2,11,5,2,0,0,6,10,1,3,0,3,0,0,0
"kaggle:titanic","parent.env",1,1,1,1,0,0,0,1,0,0,0,0,0,0,0,0,0,0
"kaggle:titanic","getFunction",44,32,32,10,22,21,9,1,0,1,17,4,4,1,3,0,1,0
"kaggle:titanic","FUN",11,9,9,0,9,7,0,0,0,2,2,5,4,0,4,0,0,0
"kaggle:titanic","parent.env",1,1,1,0,1,1,0,0,0,0,0,1,1,0,1,0,0,0
"kaggle:titanic","parent.env",1,1,1,1,0,0,0,1,0,0,0,0,1,1,0,0,1,0
"kaggle:titanic","getFunction",44,32,32,11,21,20,9,2,0,1,16,4,4,1,3,0,1,0
"kaggle:titanic","parent.env",1,1,1,0,1,1,0,0,0,0,0,1,1,0,1,0,0,0
"kaggle:titanic","parent.env",1,1,1,1,0,0,0,1,0,0,0,0,1,1,0,0,1,0
"kaggle:titanic","getFunction",44,32,32,10,22,21,9,1,0,1,17,4,4,1,3,0,1,0
"kaggle:titanic","FUN",18,9,9,2,7,7,1,1,0,0,7,0,0,0,0,0,0,0
"kaggle:titanic",".getNamespace",1,1,1,1,0,0,0,1,0,0,0,0,0,0,0,0,0,0
"kaggle:titanic","is.unit",5,5,5,1,4,2,1,0,0,2,0,2,1,0,1,0,0,0
"kaggle:titanic","numnotnull",27,5,5,1,4,4,1,0,0,0,0,4,0,0,0,0,0,0
"kaggle:titanic","checkNA",44,5,5,1,4,4,1,0,0,0,0,4,0,0,0,0,0,0
"kaggle:titanic","unit",52,24,23,8,16,12,6,2,0,4,9,5,1,0,1,0,0,0
"kaggle:titanic","textGrob",44,33,33,3,30,28,3,0,0,2,23,5,1,0,1,0,0,0
"kaggle:titanic","validGrob",1,0,0,0,0,0,0,0,0,0,0,0,0,0,0,0,0,0
"kaggle:titanic","gpar",5,3,3,0,3,3,0,0,0,0,2,1,0,0,0,0,0,0
"kaggle:titanic","validGP",265,58,58,14,44,44,14,0,0,0,35,9,4,1,3,1,0,0
"kaggle:titanic","modifyList",153,33,33,17,16,14,6,11,0,2,15,1,22,9,13,4,5,0
"kaggle:titanic","exists",8,6,6,1,5,5,0,1,0,0,2,3,4,1,3,0,1,0
"kaggle:titanic","registerS3method",116,72,72,10,62,55,8,2,0,7,54,7,20,1,19,1,0,0
"kaggle:titanic","FUN",3,1,1,1,0,0,1,0,0,0,0,0,0,0,0,0,0,0
"kaggle:titanic","FUN",3,1,1,1,0,0,1,0,0,0,0,0,0,0,0,0,0,0
"kaggle:titanic",".cacheClass",74,44,38,10,34,27,8,2,0,7,28,6,5,0,5,0,0,0
"kaggle:titanic",".cacheClass",74,44,38,10,34,27,8,2,0,7,28,6,5,0,5,0,0,0
"kaggle:titanic","get0",6,5,5,1,4,4,0,1,0,0,0,4,3,1,2,0,1,0
"kaggle:titanic","getClassDef",60,38,38,1,37,35,1,0,0,2,30,7,5,0,5,0,0,0
"kaggle:titanic",".recacheSubclasses",129,59,59,17,42,36,8,9,0,6,42,0,9,3,6,1,2,0
"kaggle:titanic","sort.list",84,34,33,13,21,16,6,7,0,5,20,1,0,0,0,0,0,0
"kaggle:titanic","rep_len",2,2,2,2,0,0,2,0,0,0,0,0,0,0,0,0,0,0
"kaggle:titanic","packageSlot",3,2,2,0,2,2,0,0,0,0,0,2,2,0,2,0,0,0
"kaggle:titanic","get",6,6,6,1,5,5,0,1,0,0,1,4,4,1,3,0,1,0
"kaggle:titanic","exists",8,6,6,1,5,5,0,1,0,0,1,4,4,1,3,0,1,0
"kaggle:titanic",".mergeMethodsTable",409,72,72,25,47,41,12,13,0,6,43,3,7,0,7,0,0,0
"kaggle:titanic","initialize",55,15,15,1,14,8,1,0,0,6,14,0,6,0,6,0,0,0
"kaggle:titanic",".allowPrimitiveMethods",6,4,4,3,1,1,2,1,0,0,0,1,0,0,0,0,0,0
"kaggle:titanic","isFALSE",11,8,3,4,4,2,4,0,0,2,2,1,1,0,1,0,0,0
"kaggle:titanic","cacheGenericsMetaData",108,54,54,7,47,43,7,0,0,4,35,11,10,0,10,0,0,0
"kaggle:titanic",".getMethodsTable",14,10,9,1,9,7,1,0,0,2,8,1,0,0,0,0,0,0
"kaggle:titanic",".newOrMultipleMethod",74,2,2,1,1,1,1,0,0,0,0,1,0,0,0,0,0,0
"kaggle:titanic",".mergeMethodsTable",409,85,85,31,54,46,14,17,0,8,50,3,11,3,8,0,3,0
"kaggle:titanic",".newOrMultipleMethod",74,2,2,1,1,1,1,0,0,0,0,1,0,0,0,0,0,0
"kaggle:titanic","getGeneric",68,32,32,6,26,26,3,3,0,0,22,4,5,1,4,0,1,0
"kaggle:titanic","isFALSE",11,8,3,4,4,2,4,0,0,2,2,1,1,0,1,0,0,0
"kaggle:titanic",".getGeneric",50,31,30,5,26,25,3,2,0,1,17,9,9,1,8,1,0,0
"kaggle:titanic",".getMethodsTable",14,10,9,1,9,7,1,0,0,2,8,1,0,0,0,0,0,0
"kaggle:titanic","isFALSE",11,8,7,4,4,2,4,0,0,2,2,1,1,0,1,0,0,0
"kaggle:titanic",".class1",10,6,6,2,4,2,1,1,0,2,2,2,1,0,1,0,0,0
"kaggle:titanic","body<-",3,1,1,0,1,1,0,0,0,0,0,1,1,0,1,0,0,0
"kaggle:titanic","isFALSE",11,8,3,4,4,2,4,0,0,2,2,1,1,0,1,0,0,0
"kaggle:titanic","isFALSE",11,8,3,4,4,2,4,0,0,2,2,1,1,0,1,0,0,0
"kaggle:titanic",".getGeneric",50,31,30,5,26,25,3,2,0,1,17,9,9,1,8,1,0,0
"kaggle:titanic",".getGeneric",50,31,30,5,26,25,3,2,0,1,17,9,9,1,8,1,0,0
"kaggle:titanic","environment",1,1,1,0,1,1,0,0,0,0,0,1,1,0,1,0,0,0
"kaggle:titanic","isTRUE",11,8,3,3,5,2,3,0,0,3,3,1,1,0,1,0,0,0
"kaggle:titanic","getClassDef",60,38,36,1,37,33,1,0,0,4,30,7,5,0,5,0,0,0
"kaggle:titanic","exists",8,6,6,0,6,6,0,0,0,0,2,4,4,0,4,0,0,0
"kaggle:titanic",".getMethodsTable",14,10,9,1,9,7,1,0,0,2,8,1,0,0,0,0,0,0
"kaggle:titanic","as",131,73,73,14,59,54,10,4,0,5,55,4,9,0,9,0,0,0
"kaggle:titanic",".quickCoerceSelect",38,11,8,1,10,6,0,1,0,4,7,3,3,0,3,0,0,0
"kaggle:titanic","formalArgs",7,3,3,1,2,2,0,1,0,0,0,2,1,0,1,0,0,0
"kaggle:titanic",".matchSigLength",93,20,20,6,14,10,4,2,0,4,10,3,3,0,3,0,0,0
"kaggle:titanic",".getGenericSigLength",8,5,5,2,3,3,2,0,0,0,3,0,0,0,0,0,0,0
"kaggle:titanic",".classEnv",38,16,16,2,14,11,0,2,0,3,11,3,4,0,4,0,0,0
"kaggle:titanic","body<-",3,1,1,0,1,1,0,0,0,0,0,1,1,0,1,0,0,0
"kaggle:titanic",".cacheMethodInTable",113,28,25,2,26,22,2,0,0,4,17,6,3,0,3,0,0,0
"kaggle:titanic",".classEnv",38,16,16,2,14,11,0,2,0,3,11,3,4,0,4,0,0,0
"kaggle:titanic","getGeneric",68,32,32,6,26,26,3,3,0,0,22,4,5,1,4,0,1,0
"kaggle:titanic","isFALSE",11,8,3,4,4,2,4,0,0,2,2,1,1,0,1,0,0,0
"kaggle:titanic",".getGeneric",50,31,30,5,26,25,3,2,0,1,17,9,9,1,8,1,0,0
"kaggle:titanic",".getMethodsTable",14,10,9,1,9,7,1,0,0,2,8,1,0,0,0,0,0,0
"kaggle:titanic","getGeneric",68,32,32,7,25,25,4,3,0,0,21,4,5,1,4,0,1,0
"kaggle:titanic","isFALSE",11,8,3,4,4,2,4,0,0,2,2,1,1,0,1,0,0,0
"kaggle:titanic","environment",1,1,1,0,1,1,0,0,0,0,0,1,1,0,1,0,0,0
"kaggle:titanic",".checkGroupSigLength",194,82,82,36,46,35,20,16,0,11,42,4,3,1,2,0,1,0
"kaggle:titanic",".getMethodsTable",14,10,9,1,9,7,1,0,0,2,8,1,0,0,0,0,0,0
"kaggle:titanic","getGroupMembers",38,25,18,3,22,13,2,1,0,9,20,2,2,0,2,0,0,0
"kaggle:titanic","getGeneric",68,32,32,6,26,26,3,3,0,0,22,4,5,1,4,0,1,0
"kaggle:titanic","isFALSE",11,8,3,4,4,2,4,0,0,2,2,1,1,0,1,0,0,0
"kaggle:titanic",".getGeneric",50,31,30,5,26,25,3,2,0,1,17,9,9,1,8,1,0,0
"kaggle:titanic",".getMethodsTable",14,10,9,1,9,7,1,0,0,2,8,1,0,0,0,0,0,0
"kaggle:titanic",".getGenericFromCacheTable",59,10,10,2,8,7,2,0,0,1,7,1,0,0,0,0,0,0
"kaggle:titanic","checkTrace",9,3,3,1,2,2,1,0,0,0,2,0,0,0,0,0,0,0
"kaggle:titanic","match",4,4,4,1,3,1,0,1,0,2,0,1,2,1,1,0,1,0
"kaggle:titanic","getDataPart",103,22,21,6,16,12,3,3,0,4,12,2,1,0,1,0,0,0
"kaggle:titanic","asMethod",9,4,4,0,4,3,0,0,0,1,2,2,0,0,0,0,0,0
"kaggle:titanic",".class1",10,6,6,2,4,2,1,1,0,2,2,2,1,0,1,0,0,0
"kaggle:titanic","isFALSE",11,8,3,4,4,2,4,0,0,2,2,1,1,0,1,0,0,0
"kaggle:titanic","genericForBasic",13,7,7,3,4,4,1,2,0,0,3,1,2,0,2,0,0,0
"kaggle:titanic","isFALSE",11,8,3,4,4,2,4,0,0,2,2,1,1,0,1,0,0,0
"kaggle:titanic",".getGeneric",50,31,30,5,26,25,3,2,0,1,17,9,9,1,8,1,0,0
"kaggle:titanic",".getGeneric",50,31,30,5,26,25,3,2,0,1,17,9,9,1,8,1,0,0
"kaggle:titanic","environment",1,1,1,0,1,1,0,0,0,0,0,1,1,0,1,0,0,0
"kaggle:titanic","isTRUE",11,8,3,3,5,2,3,0,0,3,3,1,1,0,1,0,0,0
"kaggle:titanic","exists",8,6,6,0,6,6,0,0,0,0,2,4,4,0,4,0,0,0
"kaggle:titanic",".getMethodsTable",14,10,9,1,9,7,1,0,0,2,8,1,0,0,0,0,0,0
"kaggle:titanic","as",131,73,73,14,59,54,10,4,0,5,55,4,9,0,9,0,0,0
"kaggle:titanic","formalArgs",7,3,3,1,2,2,0,1,0,0,0,2,1,0,1,0,0,0
"kaggle:titanic",".matchSigLength",93,20,20,6,14,10,4,2,0,4,10,3,3,0,3,0,0,0
"kaggle:titanic",".getGenericSigLength",8,5,5,2,3,3,2,0,0,0,3,0,0,0,0,0,0,0
"kaggle:titanic","body<-",3,1,1,0,1,1,0,0,0,0,0,1,1,0,1,0,0,0
"kaggle:titanic",".cacheMethodInTable",113,28,25,2,26,22,2,0,0,4,17,6,3,0,3,0,0,0
"kaggle:titanic",".getGenericFromCache",5,4,4,0,4,4,0,0,0,0,0,4,1,0,1,0,0,0
"kaggle:titanic",".getGenericFromCacheTable",59,10,9,2,8,7,2,0,0,1,7,1,0,0,0,0,0,0
"kaggle:titanic","assign",6,6,6,0,6,6,0,0,0,0,3,3,1,0,1,0,0,0
"kaggle:titanic","isFALSE",11,8,3,4,4,2,4,0,0,2,2,1,1,0,1,0,0,0
"kaggle:titanic","genericForBasic",13,7,7,3,4,4,1,2,0,0,3,1,2,0,2,0,0,0
"kaggle:titanic","parent.env",1,1,1,0,1,1,0,0,0,0,0,1,1,0,1,0,0,0
"kaggle:titanic",".getMethodsTable",14,10,9,1,9,7,1,0,0,2,8,1,0,0,0,0,0,0
"kaggle:titanic","getFunction",44,32,32,11,21,20,9,2,0,1,16,4,4,1,3,0,1,0
"kaggle:titanic","getFunction",44,32,32,11,21,20,9,2,0,1,16,4,4,1,3,0,1,0
"kaggle:titanic","implicitGeneric",208,102,96,19,83,64,8,11,0,19,71,10,14,2,12,1,1,0
"kaggle:titanic",".genericOrImplicit",42,27,27,3,24,20,2,1,0,4,16,6,3,0,3,0,0,0
"kaggle:titanic","assign",6,6,6,1,5,5,0,1,0,0,3,2,1,0,1,0,0,0
"kaggle:titanic","bindingIsLocked",8,7,7,1,6,4,0,1,0,2,3,2,0,0,0,0,0,0
"kaggle:titanic",".assignOverBinding",62,31,31,5,26,19,5,0,0,7,25,1,2,0,2,0,0,0
"kaggle:titanic","environment",1,1,1,0,1,1,0,0,0,0,0,1,1,0,1,0,0,0
"kaggle:titanic",".checkGroupSigLength",194,82,82,37,45,35,20,17,0,10,41,4,3,1,2,0,1,0
"kaggle:titanic",".getMethodsTable",14,10,9,1,9,7,1,0,0,2,8,1,0,0,0,0,0,0
"kaggle:titanic","getGroupMembers",38,25,18,3,22,13,2,1,0,9,20,2,2,0,2,0,0,0
"kaggle:titanic","getPackageName",93,7,7,0,7,5,0,0,0,2,6,1,0,0,0,0,0,0
"kaggle:titanic","get0",6,5,5,1,4,4,0,1,0,0,0,4,3,1,2,0,1,0
"kaggle:titanic","isFALSE",11,8,7,4,4,2,4,0,0,2,2,1,1,0,1,0,0,0
"kaggle:titanic","ifelse",105,37,36,19,18,12,12,7,0,6,12,4,23,13,10,6,7,0
"kaggle:titanic",".NamespaceOrPackage",20,9,9,1,8,6,0,1,0,2,6,1,0,0,0,0,0,0
"kaggle:titanic","parent.env<-",2,2,2,0,2,2,0,0,0,0,2,0,0,0,0,0,0,0
"kaggle:titanic",".asGroupArgument",9,3,3,0,3,2,0,0,0,1,2,1,0,0,0,0,0,0
"kaggle:titanic","get",6,6,6,1,5,5,0,1,0,0,1,4,4,1,3,0,1,0
"kaggle:titanic","exists",8,6,6,1,5,5,0,1,0,0,1,4,4,1,3,0,1,0
"kaggle:titanic",".resetInheritedMethods",54,38,36,12,26,21,4,8,0,5,21,1,16,4,12,1,3,0
"kaggle:titanic",".mlistAddToTable",29,19,19,4,15,14,4,0,0,1,13,2,0,0,0,0,0,0
"kaggle:titanic",".setupMethodsTables",75,22,22,1,21,21,1,0,0,0,18,3,0,0,0,0,0,0
"kaggle:titanic",".storeMlist",141,25,25,9,16,12,4,5,0,4,16,0,0,0,0,0,0,0
"kaggle:titanic","generic.skeleton",42,21,21,4,17,15,2,2,0,2,14,3,0,0,0,0,0,0
"kaggle:titanic",".mergeMethodsTable",335,83,83,30,53,45,13,17,0,8,50,2,11,3,8,0,3,0
"kaggle:titanic",".newOrMultipleMethod",74,2,2,1,1,1,1,0,0,0,0,1,0,0,0,0,0,0
"kaggle:titanic",".sigLabel",6,6,3,0,6,3,0,0,0,3,0,3,3,0,3,0,0,0
"kaggle:titanic","is.primitive",2,2,2,0,2,2,0,0,0,0,0,2,1,0,1,0,0,0
"kaggle:titanic",".resetTable",179,78,74,10,68,58,7,3,0,10,54,10,11,0,11,0,0,0
"kaggle:titanic",".getMethodsTable",14,10,10,2,8,8,2,0,0,0,7,1,0,0,0,0,0,0
"kaggle:titanic","getMethodsForDispatch",5,4,4,0,4,4,0,0,0,0,2,2,0,0,0,0,0,0
"kaggle:titanic",".getGeneric",50,31,30,5,26,25,3,2,0,1,17,9,9,1,8,1,0,0
"kaggle:titanic",".getGeneric",50,31,30,5,26,25,3,2,0,1,17,9,9,1,8,1,0,0
"kaggle:titanic",".getMethodsTable",14,10,9,1,9,7,1,0,0,2,8,1,0,0,0,0,0,0
"kaggle:titanic",".getMethodsTable",14,10,10,2,8,8,2,0,0,0,7,1,0,0,0,0,0,0
"kaggle:titanic",".matchSigLength",93,20,20,6,14,10,4,2,0,4,10,3,3,0,3,0,0,0
"kaggle:titanic",".getGenericSigLength",8,5,5,2,3,3,2,0,0,0,3,0,0,0,0,0,0,0
"kaggle:titanic","getMethodsForDispatch",5,4,4,0,4,4,0,0,0,0,2,2,0,0,0,0,0,0
"kaggle:titanic","as<-",146,49,46,6,43,36,3,3,0,7,36,7,7,0,7,0,0,0
"kaggle:titanic",".getGeneric",50,31,30,5,26,25,3,2,0,1,17,9,9,1,8,1,0,0
"kaggle:titanic",".getGeneric",50,31,30,5,26,25,3,2,0,1,17,9,9,1,8,1,0,0
"kaggle:titanic",".getMethodsTable",14,10,9,1,9,7,1,0,0,2,8,1,0,0,0,0,0,0
"kaggle:titanic",".matchSigLength",93,20,20,6,14,10,4,2,0,4,10,3,3,0,3,0,0,0
"kaggle:titanic",".getGenericSigLength",8,5,5,2,3,3,2,0,0,0,3,0,0,0,0,0,0,0
"kaggle:titanic","as<-",146,49,46,6,43,36,3,3,0,7,36,7,7,0,7,0,0,0
"kaggle:titanic","asMethod",4,4,4,0,4,4,0,0,0,0,3,1,0,0,0,0,0,0
"kaggle:titanic","isFALSE",11,8,3,4,4,2,4,0,0,2,2,1,1,0,1,0,0,0
"kaggle:titanic",".getGeneric",50,31,30,5,26,25,3,2,0,1,17,9,9,1,8,1,0,0
"kaggle:titanic",".getGeneric",50,31,30,5,26,25,3,2,0,1,17,9,9,1,8,1,0,0
"kaggle:titanic","environment",1,1,1,0,1,1,0,0,0,0,0,1,1,0,1,0,0,0
"kaggle:titanic","isTRUE",11,8,3,3,5,2,3,0,0,3,3,1,1,0,1,0,0,0
"kaggle:titanic",".getMethodsTable",14,10,9,1,9,7,1,0,0,2,8,1,0,0,0,0,0,0
"kaggle:titanic","as",131,73,73,14,59,54,10,4,0,5,55,4,9,0,9,0,0,0
"kaggle:titanic","formalArgs",7,3,3,1,2,2,0,1,0,0,0,2,1,0,1,0,0,0
"kaggle:titanic",".matchSigLength",93,20,20,6,14,10,4,2,0,4,10,3,3,0,3,0,0,0
"kaggle:titanic",".getGenericSigLength",8,5,5,2,3,3,2,0,0,0,3,0,0,0,0,0,0,0
"kaggle:titanic","body<-",3,1,1,0,1,1,0,0,0,0,0,1,1,0,1,0,0,0
"kaggle:titanic",".cacheMethodInTable",113,28,25,2,26,22,2,0,0,4,17,6,3,0,3,0,0,0
"kaggle:titanic","ifelse",105,37,36,19,18,12,12,7,0,6,12,4,23,13,10,6,7,0
"kaggle:titanic","FUN",3,3,3,1,2,2,1,0,0,0,0,2,0,0,0,0,0,0
"kaggle:titanic","exists",8,6,6,1,5,5,0,1,0,0,2,3,4,1,3,0,1,0
"kaggle:titanic","FUN",4,4,4,1,3,3,1,0,0,0,0,3,1,0,1,0,0,0
"kaggle:titanic","",83,49,43,10,39,25,6,4,0,14,32,2,6,0,6,0,0,0
"kaggle:titanic","unknown--fromConstant",45,18,18,4,14,12,2,2,0,2,10,2,5,0,5,0,0,0
"kaggle:titanic","as.list",1,0,0,0,0,0,0,0,0,0,0,0,0,0,0,0,0,0
"kaggle:titanic",".mergeImportMethods",19,13,13,5,8,7,0,5,0,1,7,1,3,1,2,0,1,0
"kaggle:titanic","",61,26,26,9,17,15,9,0,0,2,17,0,0,0,0,0,0,0
"kaggle:titanic","getGeneric",68,32,32,7,25,25,4,3,0,0,21,4,5,1,4,0,1,0
"kaggle:titanic",".getMethodsTable",14,10,9,1,9,7,1,0,0,2,8,1,0,0,0,0,0,0
"kaggle:titanic","",61,37,37,9,28,26,9,0,0,2,28,0,0,0,0,0,0,0
"kaggle:titanic","genericPackage",10,4,4,1,3,3,1,0,0,0,0,3,0,0,0,0,0,0
"kaggle:titanic","is.primitive",2,2,2,0,2,2,0,0,0,0,0,2,1,0,1,0,0,0
"kaggle:titanic","parent.env",1,1,1,0,1,1,0,0,0,0,0,1,1,0,1,0,0,0
"kaggle:titanic","",64,29,28,7,22,19,6,1,0,3,19,3,10,1,9,1,0,0
"kaggle:titanic","getFunction",43,31,28,10,21,21,9,1,0,0,18,3,4,0,4,0,0,0
"kaggle:titanic","environment",1,1,1,0,1,1,0,0,0,0,0,1,1,0,1,0,0,0
"kaggle:titanic","get0",6,5,5,1,4,4,0,1,0,0,0,4,3,1,2,0,1,0
"kaggle:titanic","asNamespace",33,27,20,4,23,15,4,0,0,8,19,4,3,0,3,0,0,0
"kaggle:titanic","registerS3methods",395,227,213,55,172,144,32,23,0,28,155,10,29,3,26,2,1,0
"kaggle:titanic","registerS3method",116,72,72,10,62,55,8,2,0,7,54,7,20,1,19,1,0,0
"kaggle:titanic","lazyLoadDBexec",46,36,31,6,30,26,2,4,0,4,24,4,1,0,1,0,0,0
"kaggle:titanic","lazyLoad",5,4,4,0,4,4,0,0,0,0,2,2,0,0,0,0,0,0
"kaggle:titanic","environmentName",1,1,1,1,0,0,0,1,0,0,0,0,0,0,0,0,0,0
"kaggle:titanic","get0",6,5,5,1,4,4,0,1,0,0,0,4,3,1,2,0,1,0
"kaggle:titanic",".registerS3method",83,60,54,11,49,40,3,8,0,9,40,8,8,1,7,0,1,0
"kaggle:titanic","getDLLRegisteredRoutines.DLLInfo",16,10,10,1,9,6,1,0,0,3,6,1,1,0,1,0,0,0
"kaggle:titanic","gzfile",5,5,5,0,5,5,0,0,0,0,4,1,0,0,0,0,0,0
"kaggle:titanic","force",1,1,1,0,1,1,0,0,0,0,0,1,1,0,1,0,0,0
"kaggle:titanic","eval",8,7,3,1,6,2,0,1,0,4,6,0,1,1,0,0,1,0
"kaggle:titanic","force",1,1,1,1,0,0,1,0,0,0,0,0,1,1,0,1,0,0
"kaggle:titanic","label",5,5,5,0,5,2,0,0,0,3,4,0,3,0,3,0,0,0
"kaggle:titanic","",13,9,9,0,9,9,0,0,0,0,7,2,0,0,0,0,0,0
"kaggle:titanic","is.primitive",2,2,2,0,2,2,0,0,0,0,0,2,1,0,1,0,0,0
"kaggle:titanic","asNamespace",33,27,20,4,23,15,4,0,0,8,19,4,3,0,3,0,0,0
"kaggle:titanic","namespaceImportFrom",518,228,222,61,167,149,38,23,0,18,148,16,31,5,26,3,2,0
"kaggle:titanic","parent.env",1,1,1,0,1,1,0,0,0,0,0,1,1,0,1,0,0,0
"kaggle:titanic","importIntoEnv",90,33,33,3,30,28,2,1,0,2,24,6,7,1,6,1,0,0
"kaggle:titanic","anyDuplicated",1,0,0,0,0,0,0,0,0,0,0,0,0,0,0,0,0,0
"kaggle:titanic","getNamespaceExports",29,22,22,4,18,10,2,2,0,8,14,3,4,0,4,0,0,0
"kaggle:titanic",".getMethodsTable",14,10,9,1,9,7,1,0,0,2,8,1,0,0,0,0,0,0
"kaggle:titanic","",64,29,28,7,22,19,6,1,0,3,19,3,10,1,9,1,0,0
"kaggle:titanic",".mergeImportMethods",19,13,12,5,8,7,0,5,0,1,7,1,3,1,2,0,1,0
"kaggle:titanic",".mergeImportMethods",19,13,12,6,7,6,0,6,0,1,6,1,3,1,2,0,1,0
"kaggle:titanic","",61,37,37,9,28,26,9,0,0,2,28,0,0,0,0,0,0,0
"kaggle:titanic","lazyLoadDBexec",46,36,34,6,30,26,2,4,0,4,24,4,1,0,1,0,0,0
"kaggle:titanic","assignNativeRoutines",47,36,35,7,29,24,4,3,0,5,22,4,5,2,3,0,2,0
"kaggle:titanic","getNativeSymbolInfo",31,19,19,4,15,13,2,2,0,2,10,3,1,0,1,0,0,0
"kaggle:titanic","same.isFn",21,15,14,0,15,13,0,0,0,2,6,7,9,0,9,0,0,0
"kaggle:titanic","intToUtf8",3,3,2,0,3,1,0,0,0,2,2,1,0,0,0,0,0,0
"kaggle:titanic","conditionMessage",1,0,0,0,0,0,0,0,0,0,0,0,0,0,0,0,0,0
"kaggle:titanic","not.Ident",18,12,12,0,12,12,0,0,0,0,6,6,8,0,8,0,0,0
"kaggle:titanic","stderr",0,0,0,0,0,0,0,0,0,0,0,0,0,0,0,0,0,0
"kaggle:titanic",".packageStartupMessage",60,28,26,8,20,17,4,4,0,3,15,5,6,2,4,0,2,0
"kaggle:titanic","withOneRestart",8,2,2,0,2,2,0,0,0,0,0,2,0,0,0,0,0,0
"kaggle:titanic","doWithOneRestart",6,2,2,0,2,1,0,0,0,1,1,1,0,0,0,0,0,0
"kaggle:titanic","signalCondition",14,12,12,3,9,7,1,2,0,2,6,1,1,0,1,0,0,0
"kaggle:titanic","conditionMessage",1,0,0,0,0,0,0,0,0,0,0,0,0,0,0,0,0,0
"kaggle:titanic","conditionCall",1,0,0,0,0,0,0,0,0,0,0,0,0,0,0,0,0,0
"kaggle:titanic","defaultHandler",29,12,12,0,12,6,0,0,0,6,5,5,0,0,0,0,0,0
"kaggle:titanic","as_function",61,6,6,2,4,4,2,0,0,0,2,2,3,0,3,0,0,0
"kaggle:titanic","FUN",3,3,3,0,3,3,0,0,0,0,0,3,1,0,1,0,0,0
"kaggle:titanic","FUN",6,3,3,1,2,2,1,0,0,0,0,2,1,1,0,1,0,0
"kaggle:titanic","FUN",3,3,3,0,3,3,0,0,0,0,0,3,1,0,1,0,0,0
"kaggle:titanic","FUN",6,3,3,1,2,2,1,0,0,0,0,2,1,1,0,1,0,0
"kaggle:titanic","pmatch",8,6,6,2,4,4,1,1,0,0,3,1,0,0,0,0,0,0
"kaggle:titanic","exists",8,6,6,0,6,6,0,0,0,0,2,4,4,0,4,0,0,0
"kaggle:titanic","FUN",3,3,3,0,3,3,0,0,0,0,0,3,1,0,1,0,0,0
"kaggle:titanic","stdout",0,0,0,0,0,0,0,0,0,0,0,0,0,0,0,0,0,0
"kaggle:titanic","FUN",3,3,3,0,3,3,0,0,0,0,0,3,1,0,1,0,0,0
"kaggle:titanic","FUN",3,3,3,0,3,3,0,0,0,0,0,3,1,0,1,0,0,0
"kaggle:titanic","modifyList",153,61,61,21,40,38,4,17,0,2,38,2,24,6,18,2,4,0
"kaggle:titanic","modifyList",153,61,61,21,40,38,4,17,0,2,38,2,24,6,18,2,4,0
"kaggle:titanic","FUN",3,3,3,0,3,3,0,0,0,0,0,3,1,0,1,0,0,0
"kaggle:titanic","nchar",4,4,4,3,1,0,1,2,0,1,1,0,1,1,0,0,1,0
"kaggle:titanic","mode",17,10,10,1,9,5,0,1,1,4,8,0,5,1,4,0,1,1
"kaggle:titanic","FUN",3,3,3,0,3,3,0,0,0,0,0,3,1,0,1,0,0,0
"kaggle:titanic","sub",45,18,18,4,14,12,2,2,0,2,10,2,2,0,2,0,0,0
"kaggle:titanic","FUN",3,3,3,0,3,3,0,0,0,0,0,3,1,0,1,0,0,0
"kaggle:titanic","match.arg",77,53,52,15,38,26,10,5,0,12,32,4,5,0,5,0,0,0
"kaggle:titanic","FUN",3,3,3,0,3,3,0,0,0,0,0,3,1,0,1,0,0,0
"kaggle:titanic","do.call",9,9,9,1,8,8,0,1,0,0,5,3,3,1,2,0,1,0
"kaggle:titanic","formals",10,5,5,0,5,5,0,0,0,0,2,3,2,0,2,0,0,0
"kaggle:titanic","FUN",3,3,3,0,3,3,0,0,0,0,0,3,1,0,1,0,0,0
"kaggle:titanic","strOptions",17,9,4,0,9,3,0,0,0,6,5,1,0,0,0,0,0,0
"kaggle:titanic","%||%",3,2,2,2,0,0,1,1,0,0,0,0,0,0,0,0,0,0
"kaggle:titanic","",8,5,5,1,4,2,1,0,0,2,0,2,2,0,2,0,0,0
"kaggle:titanic","substr",13,7,7,3,4,4,2,1,0,0,3,1,0,0,0,0,0,0
"kaggle:titanic","nchar.w",6,6,6,1,5,1,0,1,0,4,2,1,3,1,2,0,1,0
"kaggle:titanic","FUN",3,3,3,0,3,3,0,0,0,0,0,3,1,0,1,0,0,0
"kaggle:titanic","FUN",3,3,3,0,3,3,0,0,0,0,0,3,1,0,1,0,0,0
"kaggle:titanic","FUN",11,10,7,3,7,1,0,3,0,6,6,0,1,0,1,0,0,0
"kaggle:titanic","is_string",7,4,4,1,3,3,1,0,0,0,0,3,1,0,1,0,0,0
"kaggle:titanic","is_quosure",5,5,5,1,4,2,1,0,0,2,0,2,1,0,1,0,0,0
"kaggle:titanic","substring",36,18,18,7,11,5,4,3,0,6,11,0,0,0,0,0,0,0
"kaggle:titanic","strsplit",7,6,4,3,3,1,1,2,0,2,3,0,1,1,0,0,1,0
"kaggle:titanic","eval",8,7,3,1,6,2,1,0,0,4,5,1,2,1,1,1,0,0
"kaggle:titanic","environment",1,1,1,0,1,1,0,0,0,0,0,1,1,0,1,0,0,0
"kaggle:titanic","as.vector",2,2,2,0,2,1,0,0,0,1,0,1,1,0,1,0,0,0
"kaggle:titanic","enexpr",9,4,4,0,4,4,0,0,0,0,0,4,0,0,0,0,0,0
"kaggle:titanic","make_proto_method",29,16,16,2,14,12,1,1,0,2,6,7,0,0,0,0,0,0
"kaggle:titanic","as.vector",2,2,2,1,1,0,1,0,0,1,0,0,1,1,0,1,0,0
"kaggle:titanic","is_missing",10,10,10,1,9,2,1,0,0,7,8,1,3,0,3,0,0,0
"kaggle:titanic","list2env",14,3,3,0,3,2,0,0,0,1,2,1,0,0,0,0,0,0
"kaggle:titanic","eval",8,7,3,1,6,2,1,0,0,4,5,1,2,1,1,1,0,0
"kaggle:titanic","super",3,3,3,0,3,3,0,0,0,0,0,3,0,0,0,0,0,0
"kaggle:titanic","duplicated",1,0,0,0,0,0,0,0,0,0,0,0,0,0,0,0,0,0
"kaggle:titanic","new.env",4,4,4,3,1,1,1,2,0,0,0,1,2,2,0,0,2,0
"kaggle:titanic","ggproto",70,30,29,7,23,17,5,2,0,6,14,6,8,3,5,1,2,0
"kaggle:titanic","unknown--fromConstant",5,3,3,0,3,3,0,0,0,0,0,3,1,0,1,0,0,0
"kaggle:titanic","match.fun",40,15,15,3,12,11,2,1,0,1,11,1,2,1,1,1,0,0
"kaggle:titanic","get",6,6,6,1,5,5,0,1,0,0,2,3,4,1,3,0,1,0
"kaggle:titanic","check_fun",5,5,5,1,4,2,1,0,0,2,0,2,1,0,1,0,0,0
"kaggle:titanic","duplicated",1,0,0,0,0,0,0,0,0,0,0,0,0,0,0,0,0,0
"kaggle:titanic","merge_vectors",28,21,21,11,10,10,3,8,0,0,9,1,13,7,6,1,6,0
"kaggle:titanic","FUN",6,5,5,1,4,4,0,1,0,0,2,2,0,0,0,0,0,0
"kaggle:titanic","",3,3,3,0,3,3,0,0,0,0,2,1,0,0,0,0,0,0
"kaggle:titanic","unit",52,24,24,8,16,14,5,3,0,2,9,5,7,2,5,1,1,0
"kaggle:titanic","maybe_missing",15,15,15,2,13,6,2,0,0,7,12,1,5,0,5,0,0,0
"kaggle:titanic","is_missing",10,10,10,1,9,2,1,0,0,7,8,1,3,0,3,0,0,0
"kaggle:titanic","missing_arg",3,2,2,0,2,2,0,0,0,0,0,2,0,0,0,0,0,0
"kaggle:titanic","",13,13,13,2,11,4,2,0,0,7,10,1,3,0,3,0,0,0
"kaggle:titanic","deprecated",4,3,3,0,3,3,0,0,0,0,0,3,0,0,0,0,0,0
"kaggle:titanic","rel",57,25,23,8,17,14,4,4,0,3,15,2,6,2,4,0,2,0
"kaggle:titanic","logical",1,1,1,0,1,1,0,0,0,0,0,1,1,0,1,0,0,0
"kaggle:titanic","mode",17,14,14,3,11,7,0,3,1,4,8,2,5,1,4,0,1,1
"kaggle:titanic",".deparseOpts",83,30,23,11,19,13,9,2,0,6,15,2,4,1,3,1,0,0
"kaggle:titanic","deparse",11,11,11,2,9,9,1,1,0,0,8,1,2,1,1,0,1,0
"kaggle:titanic","%in%",4,4,4,1,3,3,1,0,0,0,2,1,4,1,3,1,0,0
"kaggle:titanic","recursive_merge",12,9,9,0,9,9,0,0,0,0,6,3,3,0,3,0,0,0
"kaggle:titanic","get",6,6,6,1,5,5,0,1,0,0,2,3,4,1,3,0,1,0
"kaggle:titanic","assign_func_envs",4,3,3,0,3,3,0,0,0,0,0,3,1,0,1,0,0,0
"kaggle:titanic","list2env2",21,8,8,1,7,6,1,0,0,1,7,0,0,0,0,0,0,0
"kaggle:titanic","lockBinding",8,7,7,1,6,6,0,1,0,0,4,2,0,0,0,0,0,0
"kaggle:titanic","FUN",1,0,0,0,0,0,0,0,0,0,0,0,0,0,0,0,0,0
"kaggle:titanic","toupper",7,3,3,0,3,3,0,0,0,0,2,1,0,0,0,0,0,0
"kaggle:titanic","valid.just",8,4,4,1,3,3,0,1,0,0,1,2,0,0,0,0,0,0
"kaggle:titanic","valid.charjust",92,31,29,5,26,15,5,0,0,11,25,1,0,0,0,0,0,0
"kaggle:titanic","unit",52,24,24,8,16,14,5,3,0,2,9,5,7,2,5,1,1,0
"kaggle:titanic","check_object",17,3,3,1,2,1,1,0,0,1,0,1,1,0,1,0,0,0
"kaggle:titanic","make_proto_method",33,23,23,4,19,17,3,1,0,2,9,9,5,1,4,1,0,0
"kaggle:titanic","",0,0,0,0,0,0,0,0,0,0,0,0,0,0,0,0,0,0
"kaggle:titanic","get_superclassnames",18,8,8,2,6,6,0,2,0,0,4,2,1,0,1,0,0,0
"kaggle:titanic","match.fun",40,15,15,3,12,11,2,1,0,1,10,2,4,0,4,0,0,0
"kaggle:titanic","get",6,6,6,1,5,5,0,1,0,0,2,3,4,1,3,0,1,0
"kaggle:titanic","sys.frame",1,1,1,1,0,0,0,1,0,0,0,0,1,1,0,0,1,0
"kaggle:titanic","get_inherit",3,3,3,0,3,3,0,0,0,0,0,3,0,0,0,0,0,0
"kaggle:titanic","intersect",15,11,11,1,10,7,0,1,0,3,7,1,1,0,1,0,0,0
"kaggle:titanic","nrow",4,3,3,1,2,2,1,0,0,0,0,2,1,0,1,0,0,0
"kaggle:titanic","%||%",3,3,3,1,2,1,1,0,0,1,2,0,3,1,2,1,0,0
"kaggle:titanic","inject",10,5,5,0,5,5,0,0,0,0,2,3,0,0,0,0,0,0
"kaggle:titanic","sort",8,5,3,0,5,0,0,0,0,5,4,0,0,0,0,0,0,0
"kaggle:titanic",".doSortWrap",40,22,22,10,12,10,7,3,0,2,11,0,2,1,1,0,1,0
"kaggle:titanic",".makeSortEnum",13,5,4,3,2,2,3,0,0,0,2,0,0,0,0,0,0,0
"kaggle:titanic","ncol",4,3,3,1,2,2,1,0,0,0,0,2,1,0,1,0,0,0
"kaggle:titanic","is_call",11,6,6,1,5,5,1,0,0,0,2,3,1,0,1,0,0,0
"kaggle:titanic","get_expr",8,5,5,0,5,5,0,0,0,0,3,2,4,0,4,0,0,0
"kaggle:titanic","is_symbol",10,6,6,0,6,4,0,0,0,2,2,2,2,0,2,0,0,0
"kaggle:titanic","is.waive",5,5,5,1,4,2,1,0,0,2,0,2,1,0,1,0,0,0
"kaggle:titanic","unlist",27,5,5,0,5,5,0,0,0,0,5,0,2,0,2,0,0,0
"kaggle:titanic","empty",22,20,20,6,14,12,6,0,0,2,6,6,3,0,3,0,0,0
"kaggle:titanic","FUN",19,14,14,5,9,6,4,1,0,3,4,3,6,1,5,0,1,0
"kaggle:titanic","Sys.getenv",59,19,17,6,13,5,4,2,0,8,11,0,1,0,1,0,0,0
"kaggle:titanic","",35,2,2,0,2,2,0,0,0,0,2,0,0,0,0,0,0,0
"kaggle:titanic","get",6,6,6,1,5,5,0,1,0,0,2,3,4,1,3,0,1,0
"kaggle:titanic","create_formatter",90,52,52,19,33,25,17,2,0,8,31,2,15,1,14,1,0,0
"kaggle:titanic","match",4,4,4,0,4,4,0,0,0,0,0,4,2,0,2,0,0,0
"kaggle:titanic","get",6,6,6,1,5,5,0,1,0,0,2,3,4,1,3,0,1,0
"kaggle:titanic","stop_if_not",18,3,3,1,2,1,1,0,0,1,2,0,0,0,0,0,0,0
"kaggle:titanic","is_builtin_style",20,17,17,5,12,8,4,1,0,4,9,3,4,1,3,1,0,0
"kaggle:titanic","make_ansi_style",215,141,139,24,117,104,10,14,0,13,100,14,24,2,22,0,2,0
"kaggle:titanic","is_r_color",23,18,18,8,10,10,5,3,0,0,7,3,4,1,3,1,0,0
"kaggle:titanic","ansi_style_8_from_rgb",38,28,26,4,24,21,2,2,0,3,17,4,1,0,1,0,0,0
"kaggle:titanic","ansi256",109,38,38,14,24,23,8,6,0,1,19,5,0,0,0,0,0,0
"kaggle:titanic","create_formatter",90,61,61,20,41,33,17,3,0,8,38,3,19,1,18,1,0,0
"kaggle:titanic","sink.number",5,5,5,2,3,2,1,1,0,1,3,0,0,0,0,0,0,0
"kaggle:titanic","isatty",6,6,6,1,5,3,1,0,0,2,2,1,1,0,1,0,0,0
"kaggle:titanic","sink.number",5,5,4,2,3,1,1,1,0,2,3,0,0,0,0,0,0,0
"kaggle:titanic","get_real_output",120,51,39,17,34,22,11,6,0,12,19,11,6,1,5,1,0,0
"kaggle:titanic","is_interactive",45,37,34,10,27,13,8,2,0,14,22,3,5,0,5,0,0,0
"kaggle:titanic","get_real_output",120,51,39,17,34,22,11,6,0,12,19,11,6,1,5,1,0,0
"kaggle:titanic","num_ansi_colors",253,117,107,40,77,49,25,15,0,28,62,11,8,1,7,1,0,0
"kaggle:titanic","no_sink",9,9,8,4,5,4,3,1,0,1,5,0,0,0,0,0,0,0
"kaggle:titanic","get_default_number_of_colors",10,7,5,0,7,3,0,0,0,4,5,2,0,0,0,0,0,0
"kaggle:titanic","os_type",3,2,2,0,2,2,0,0,0,0,0,2,0,0,0,0,0,0
"kaggle:titanic","substr",13,7,7,4,3,3,1,3,0,0,1,2,5,3,2,0,3,0
"kaggle:titanic","unknown--fromConstant",17,11,11,3,8,8,1,2,0,0,5,3,5,2,3,0,2,0
"kaggle:titanic","FUN",19,13,10,4,9,1,1,3,0,8,7,1,4,1,3,0,1,0
"kaggle:titanic","get",6,6,6,1,5,5,0,1,0,0,2,3,4,1,3,0,1,0
"kaggle:titanic","FUN",5,5,5,0,5,5,0,0,0,0,4,1,0,0,0,0,0,0
"kaggle:titanic","grepl",56,16,16,3,13,11,2,1,0,2,9,2,2,0,2,0,0,0
"kaggle:titanic","FUN",133,65,60,16,49,36,6,10,0,13,39,7,16,4,12,0,4,0
"kaggle:titanic","FUN",133,65,60,13,52,39,3,10,0,13,41,8,33,7,26,1,6,0
"kaggle:titanic",".deparseOpts",83,30,30,12,18,14,9,3,0,4,14,2,4,1,3,1,0,0
"kaggle:titanic","deparse",11,11,11,2,9,9,1,1,0,0,8,1,2,1,1,0,1,0
"kaggle:titanic","rep_len",2,2,2,2,0,0,0,2,0,0,0,0,2,2,0,0,2,0
"kaggle:titanic",".row_names_info",2,2,2,0,2,1,0,0,0,1,0,1,0,0,0,0,0,0
"kaggle:titanic","setdiff",22,18,18,2,16,15,1,1,0,1,13,2,11,2,9,1,1,0
"kaggle:titanic","match_selector",69,25,25,8,17,12,6,2,0,5,17,0,0,0,0,0,0,0
"kaggle:titanic","match_selector_node",81,38,38,12,26,26,8,4,0,0,25,1,7,2,5,1,1,0
"kaggle:titanic","%||%",3,3,3,1,2,1,1,0,0,1,0,1,3,1,2,1,0,0
"kaggle:titanic","modifyList",153,61,61,21,40,38,4,17,0,2,39,1,24,6,18,2,4,0
"kaggle:titanic","%||%",3,3,3,1,2,1,1,0,0,1,1,1,3,1,2,1,0,0
"kaggle:titanic","match_selector",69,42,42,13,29,22,11,2,0,7,29,0,4,2,2,0,2,0
"kaggle:titanic","is_flag",10,7,6,1,6,1,1,0,0,5,5,0,0,0,0,0,0,0
"kaggle:titanic","FUN",11,7,7,3,4,2,3,0,0,2,2,1,3,0,3,0,0,0
"kaggle:titanic","%||%",3,3,3,0,3,2,0,0,0,1,2,1,3,0,3,0,0,0
"kaggle:titanic","new_uuid",10,9,7,1,8,6,1,0,0,2,2,4,1,0,1,0,0,0
"kaggle:titanic","modifyList",153,61,61,21,40,38,4,17,0,2,39,1,24,6,18,2,4,0
"kaggle:titanic","%||%",3,3,3,1,2,1,1,0,0,1,1,1,3,1,2,1,0,0
"kaggle:titanic","FUN",13,12,12,1,11,5,1,0,0,6,10,1,2,0,2,0,0,0
"kaggle:titanic","",57,7,7,2,5,5,2,0,0,0,0,5,0,0,0,0,0,0
"kaggle:titanic","Encoding",1,1,1,0,1,1,0,0,0,0,0,1,0,0,0,0,0,0
"kaggle:titanic","rstudio_detect",95,31,19,11,20,10,6,5,0,10,12,6,1,0,1,0,0,0
"kaggle:titanic","%||%",4,4,4,2,2,1,1,1,0,1,1,1,3,2,1,1,1,0
"kaggle:titanic","is_environment",4,4,4,1,3,2,0,1,0,1,0,2,1,0,1,0,0,0
"kaggle:titanic","is_named",20,12,12,2,10,6,2,0,0,4,7,2,10,1,9,1,0,0
"kaggle:titanic","",10,10,10,1,9,2,1,0,0,7,8,1,3,0,3,0,0,0
"kaggle:titanic","conditionCall",1,0,0,0,0,0,0,0,0,0,0,0,0,0,0,0,0,0
"kaggle:titanic","vec_slice",10,5,5,0,5,4,0,0,0,1,2,3,2,0,2,0,0,0
"kaggle:titanic","levels",1,0,0,0,0,0,0,0,0,0,0,0,0,0,0,0,0,0
"kaggle:titanic","flip_data",28,17,15,1,16,3,1,0,0,13,12,1,4,0,4,0,0,0
"kaggle:titanic","aperm",1,0,0,0,0,0,0,0,0,0,0,0,0,0,0,0,0,0
"kaggle:titanic","unique0",4,3,3,0,3,3,0,0,0,0,3,0,3,0,3,0,0,0
"kaggle:titanic","vec_slice",10,5,5,0,5,4,0,0,0,1,2,3,2,0,2,0,0,0
"kaggle:titanic","vec_unique",4,4,4,0,4,4,0,0,0,0,3,1,3,0,3,0,0,0
"kaggle:titanic","vec_unique_loc",5,3,3,0,3,3,0,0,0,0,0,3,1,0,1,0,0,0
"kaggle:titanic","get",6,6,6,1,5,5,0,1,0,0,2,3,4,1,3,0,1,0
"kaggle:titanic","unknown--fromConstant",12,6,6,0,6,6,0,0,0,0,2,4,1,0,1,0,0,0
"kaggle:titanic","apply_fun",65,25,25,5,20,18,5,0,0,2,16,4,4,1,3,1,0,0
"kaggle:titanic","FUN",5,3,3,1,2,2,1,0,0,0,0,2,1,0,1,0,0,0
"kaggle:titanic","setNames",4,3,3,1,2,2,0,1,0,0,1,1,0,0,0,0,0,0
"kaggle:titanic","FUN",6,4,4,0,4,4,0,0,0,0,0,4,2,0,2,0,0,0
"kaggle:titanic","inherits",3,3,3,0,3,2,0,0,0,1,0,2,1,0,1,0,0,0
"kaggle:titanic","FUN",15,9,9,2,7,7,2,0,0,0,4,3,6,1,5,1,0,0
"kaggle:titanic","withCallingHandlers",16,13,13,6,7,4,2,4,0,3,5,2,1,0,1,0,0,0
"kaggle:titanic","suppressWarnings",2,2,2,0,2,2,0,0,0,0,2,0,2,0,2,0,0,0
"kaggle:titanic","get_transformation",3,2,2,0,2,2,0,0,0,0,0,2,1,0,1,0,0,0
"kaggle:titanic","is.logint",9,6,5,0,6,1,0,0,0,5,3,1,1,0,1,0,0,0
"kaggle:titanic","unknown--fromOverride",489,83,83,34,49,38,22,12,0,11,45,0,25,12,13,1,11,0
"kaggle:titanic","",10,8,8,2,6,6,1,1,0,0,6,0,0,0,0,0,0,0
"kaggle:titanic","unknown--fromConstant",1,1,1,0,1,0,0,0,0,1,0,0,0,0,0,0,0,0
"kaggle:titanic","diff",1,0,0,0,0,0,0,0,0,0,0,0,0,0,0,0,0,0
"kaggle:titanic","is.waive",5,5,5,1,4,2,1,0,0,2,0,2,2,0,2,0,0,0
"kaggle:titanic",".coverage.max",21,21,21,1,20,13,1,0,0,7,19,1,0,0,0,0,0,0
"kaggle:titanic",".density.max",9,9,9,0,9,7,0,0,0,2,8,1,0,0,0,0,0,0
"kaggle:titanic","unknown--fromOverride",489,138,137,55,83,66,40,15,0,17,78,1,25,12,13,1,11,0
"kaggle:titanic","",10,8,8,2,6,6,1,1,0,0,6,0,0,0,0,0,0,0
"kaggle:titanic","waiver",57,28,26,8,20,17,4,4,0,3,17,3,6,2,4,0,2,0
"kaggle:titanic","censor",32,20,20,9,11,10,6,3,0,1,9,1,3,2,1,0,2,0
"kaggle:titanic","ifelse",105,56,55,24,32,22,14,10,0,10,27,3,23,13,10,6,7,0
"kaggle:titanic","is_empty",29,9,9,2,7,7,1,1,0,0,6,1,0,0,0,0,0,0
"kaggle:titanic","get",6,6,6,1,5,5,0,1,0,0,2,3,4,1,3,0,1,0
"kaggle:titanic","FUN",39,23,23,6,17,16,5,1,0,1,13,4,0,0,0,0,0,0
"kaggle:titanic","FUN",21,13,13,2,11,11,1,1,0,0,7,4,0,0,0,0,0,0
"kaggle:titanic","grep",95,19,19,2,17,15,2,0,0,2,13,2,2,0,2,0,0,0
"kaggle:titanic","zero_range",60,37,37,10,27,19,9,1,0,8,25,2,0,0,0,0,0,0
"kaggle:titanic","%||%",3,3,3,0,3,2,0,0,0,1,3,0,3,0,3,0,0,0
"kaggle:titanic","%|W|%",9,9,9,2,7,5,2,0,0,2,2,3,5,0,5,0,0,0
"kaggle:titanic","unname",12,6,6,0,6,6,0,0,0,0,3,3,5,0,5,0,0,0
"kaggle:titanic","inherits",3,3,3,0,3,2,0,0,0,1,0,2,1,0,1,0,0,0
"kaggle:titanic","formals",10,5,3,0,5,2,0,0,0,3,2,1,2,0,2,0,0,0
"kaggle:titanic","is_quosure",5,5,5,1,4,2,1,0,0,2,0,2,2,0,2,0,0,0
"kaggle:titanic","tryCatchOne",33,10,10,1,9,9,0,1,0,0,4,5,1,0,1,0,0,0
"kaggle:titanic","FUN",14,14,14,6,8,7,6,0,0,1,7,0,1,0,1,0,0,0
"kaggle:titanic","lapply",17,16,15,0,16,14,0,0,0,2,11,3,10,0,10,0,0,0
"kaggle:titanic","get",6,6,6,1,5,5,0,1,0,0,2,3,4,1,3,0,1,0
"kaggle:titanic","unknown--fromConstant",12,7,7,0,7,7,0,0,0,0,4,3,2,0,2,0,0,0
"kaggle:titanic","FUN",17,15,15,0,15,15,0,0,0,0,8,7,0,0,0,0,0,0
"kaggle:titanic","",107,45,41,9,36,23,5,4,0,13,27,7,3,0,3,0,0,0
"kaggle:titanic","numnotnull",27,17,17,10,7,7,2,8,0,0,4,3,2,0,2,0,0,0
"kaggle:titanic","check.length",13,5,5,4,1,1,1,3,0,0,0,1,1,1,0,0,1,0
"kaggle:titanic","inherits",3,3,3,0,3,3,0,0,0,0,0,3,2,0,2,0,0,0
"kaggle:titanic","isTRUE",11,8,3,3,5,2,3,0,0,3,3,1,1,0,1,0,0,0
"kaggle:titanic","get",6,6,6,1,5,5,0,1,0,0,2,3,4,1,3,0,1,0
"kaggle:titanic","calc_element",99,51,51,6,45,42,5,1,0,3,40,4,9,1,8,0,1,0
"kaggle:titanic","get_element_tree",3,2,2,0,2,2,0,0,0,0,0,2,0,0,0,0,0,0
"kaggle:titanic","get",6,6,6,1,5,5,0,1,0,0,2,3,4,1,3,0,1,0
"kaggle:titanic","Reduce",185,25,24,6,19,15,6,0,0,4,16,1,2,0,2,0,0,0
"kaggle:titanic","f",105,41,41,12,29,27,10,2,0,2,21,6,5,0,5,0,0,0
"kaggle:titanic","is.grob",5,5,5,1,4,2,1,0,0,2,0,2,2,0,2,0,0,0
"kaggle:titanic","isFALSE",11,8,7,4,4,2,4,0,0,2,2,1,1,0,1,0,0,0
"kaggle:titanic","FUN",10,7,7,2,5,3,2,0,0,2,0,3,2,0,2,0,0,0
"kaggle:titanic","simplify2array",151,26,25,8,18,12,5,3,0,6,17,1,10,3,7,0,3,0
"kaggle:titanic","FUN",3,2,2,0,2,2,0,0,0,0,0,2,0,0,0,0,0,0
"kaggle:titanic","character",1,1,1,0,1,1,0,0,0,0,0,1,1,0,1,0,0,0
"kaggle:titanic","get",6,6,6,1,5,5,0,1,0,0,2,3,4,1,3,0,1,0
"kaggle:titanic","f",105,41,41,12,29,27,10,2,0,2,23,4,7,0,7,0,0,0
"kaggle:titanic","is.subclass",46,35,35,7,28,24,4,3,0,4,22,4,13,3,10,1,2,0
"kaggle:titanic","is.rel",5,5,5,1,4,2,1,0,0,2,0,2,3,0,3,0,0,0
"kaggle:titanic","is_theme_element",18,14,13,3,11,6,3,0,0,5,7,2,5,0,5,0,0,0
"kaggle:titanic","unit",52,24,24,8,16,14,5,3,0,2,9,5,8,2,6,1,1,0
"kaggle:titanic","is.unsorted",21,9,9,5,4,4,4,1,0,0,4,0,0,0,0,0,0,0
"kaggle:titanic","modify_list",16,13,13,10,3,3,0,10,0,0,2,1,4,2,2,0,2,0
"kaggle:titanic","is.simpleUnit",5,5,5,1,4,2,1,0,0,2,0,2,3,0,3,0,0,0
"kaggle:titanic","FUN",5,3,3,0,3,3,0,0,0,0,2,1,1,0,1,0,0,0
"kaggle:titanic","%||%",3,3,3,0,3,2,0,0,0,1,3,0,3,0,3,0,0,0
"kaggle:titanic","get",6,6,6,1,5,5,0,1,0,0,2,3,4,1,3,0,1,0
"kaggle:titanic","sapply",32,25,24,7,18,14,4,3,0,4,13,3,9,0,9,0,0,0
"kaggle:titanic","setPackageSlot",6,6,6,2,4,2,0,2,0,2,2,1,1,0,1,0,0,0
"kaggle:titanic","try",4,2,2,0,2,2,0,0,0,0,2,0,2,0,2,0,0,0
"kaggle:titanic","unlist",27,5,5,1,4,4,0,1,0,0,4,0,2,1,1,0,1,0
"kaggle:titanic","validGP",243,81,81,18,63,61,18,0,0,2,50,11,38,1,37,1,0,0
"kaggle:titanic","arg_match0",12,5,5,0,5,5,0,0,0,0,2,3,1,0,1,0,0,0
"kaggle:titanic","get",6,6,6,1,5,5,0,1,0,0,2,3,4,1,3,0,1,0
"kaggle:titanic","calc_element",99,51,51,5,46,42,4,1,0,4,39,6,13,1,12,0,1,0
"kaggle:titanic","get",6,6,6,1,5,5,0,1,0,0,2,3,4,1,3,0,1,0
"kaggle:titanic","Reduce",185,31,30,5,26,23,5,0,0,3,23,1,8,1,7,1,0,0
"kaggle:titanic","f",105,49,49,15,34,32,13,2,0,2,26,6,9,0,9,0,0,0
"kaggle:titanic","get",6,6,6,1,5,5,0,1,0,0,2,3,4,1,3,0,1,0
"kaggle:titanic","calc_element",99,51,51,6,45,42,5,1,0,3,38,6,13,1,12,0,1,0
"kaggle:titanic","upgradeUnit",9,8,8,2,6,4,2,0,0,2,2,2,5,0,5,0,0,0
"kaggle:titanic","as.vector",2,2,2,0,2,1,0,0,0,1,0,1,1,0,1,0,0,0
"kaggle:titanic","FUN",5,3,3,0,3,3,0,0,0,0,2,1,1,0,1,0,0,0
"kaggle:titanic","is.newUnit",5,5,5,1,4,2,1,0,0,2,0,2,3,0,3,0,0,0
"kaggle:titanic","numeric",1,1,1,0,1,1,0,0,0,0,0,1,1,0,1,0,0,0
"kaggle:titanic","unit",54,34,34,11,23,21,8,3,0,2,16,5,9,2,7,1,1,0
"kaggle:titanic","dontCheck",1,1,1,0,1,1,0,0,0,0,0,1,0,0,0,0,0,0
"kaggle:titanic","grid.Call",5,4,4,0,4,4,0,0,0,0,3,1,1,0,1,0,0,0
"kaggle:titanic","identicalUnits",5,3,3,0,3,3,0,0,0,0,0,3,2,0,2,0,0,0
"kaggle:titanic","valid.just",8,7,7,1,6,6,0,1,0,0,4,2,1,1,0,0,1,0
"kaggle:titanic","valid.numjust",13,7,7,2,5,2,2,0,0,3,5,0,0,0,0,0,0,0
"kaggle:titanic","numeric",1,1,1,0,1,0,0,0,0,1,0,0,1,0,1,0,0,0
"kaggle:titanic","is.grob",5,5,3,1,4,2,1,0,0,2,0,2,2,0,2,0,0,0
"kaggle:titanic","check.length",13,5,5,4,1,1,1,3,0,0,0,1,1,1,0,0,1,0
"kaggle:titanic","get",6,6,6,1,5,5,0,1,0,0,2,3,4,1,3,0,1,0
"kaggle:titanic","sapply",32,25,24,7,18,14,4,3,0,4,13,3,9,0,9,0,0,0
"kaggle:titanic","setChildren",51,22,22,3,19,17,3,0,0,2,11,6,5,0,5,0,0,0
"kaggle:titanic","isTRUE",11,8,8,4,4,3,4,0,0,1,3,1,2,1,1,1,0,0
"kaggle:titanic","ggname",7,1,1,0,1,1,0,0,0,0,0,1,0,0,0,0,0,0
"kaggle:titanic","neg_to_pos",8,8,8,1,7,7,1,0,0,0,5,2,0,0,0,0,0,0
"kaggle:titanic","new_data_frame",22,16,16,8,8,7,5,3,0,1,4,3,3,1,2,0,1,0
"kaggle:titanic","ifelse",105,56,55,24,32,22,14,10,0,10,27,3,23,13,10,6,7,0
"kaggle:titanic","check_gtable",20,8,8,2,6,3,2,0,0,3,0,3,2,0,2,0,0,0
"kaggle:titanic","zeroGrob",1,1,1,0,1,1,0,0,0,0,0,1,0,0,0,0,0,0
"kaggle:titanic","check_number_whole",22,9,9,1,8,7,1,0,0,1,6,2,0,0,0,0,0,0
"kaggle:titanic","is_list",7,4,4,1,3,3,1,0,0,0,0,3,1,0,1,0,0,0
"kaggle:titanic","neg_to_pos",8,8,8,1,7,7,1,0,0,0,5,2,0,0,0,0,0,0
"kaggle:titanic","single_unit",20,7,7,0,7,7,0,0,0,0,0,7,0,0,0,0,0,0
"kaggle:titanic","is.gpar",5,5,5,1,4,2,1,0,0,2,0,2,2,0,2,0,0,0
"kaggle:titanic","is.pattern",5,5,5,1,4,2,1,0,0,2,0,2,3,0,3,0,0,0
"kaggle:titanic","valid.charjust",92,33,31,5,28,17,5,0,0,11,27,1,0,0,0,0,0,0
"kaggle:titanic","valid.viewport",152,111,108,33,78,66,27,6,0,12,67,7,16,0,16,0,0,0
"kaggle:titanic","diff",1,0,0,0,0,0,0,0,0,0,0,0,0,0,0,0,0,0
"kaggle:titanic","vpObject",50,28,28,0,28,28,0,0,0,0,21,7,8,0,8,0,0,0
"kaggle:titanic","get",6,6,6,1,5,5,0,1,0,0,2,3,4,1,3,0,1,0
"kaggle:titanic","setChildren",51,22,22,3,19,17,3,0,0,2,11,6,5,0,5,0,0,0
"kaggle:titanic","set.gpar",133,59,57,13,46,42,13,0,0,4,38,6,15,1,14,1,0,0
"kaggle:titanic","preDraw",1,0,0,0,0,0,0,0,0,0,0,0,0,0,0,0,0,0
"kaggle:titanic","makeContent",1,0,0,0,0,0,0,0,0,0,0,0,0,0,0,0,0,0
"kaggle:titanic","drawDetails",1,0,0,0,0,0,0,0,0,0,0,0,0,0,0,0,0,0
"kaggle:titanic","grid.draw",2,1,1,0,1,1,0,0,0,0,0,1,0,0,0,0,0,0
"kaggle:titanic","postDraw",1,0,0,0,0,0,0,0,0,0,0,0,0,0,0,0,0,0
"kaggle:titanic","match",4,4,4,0,4,4,0,0,0,0,0,4,3,0,3,0,0,0
"kaggle:titanic","strsplit",7,6,3,1,5,2,0,1,0,3,4,1,1,0,1,0,0,0
"kaggle:titanic","rootVP",4,3,3,1,2,2,1,0,0,0,0,2,0,0,0,0,0,0
"kaggle:titanic","vpPathFromVector",88,35,34,6,29,22,3,3,0,7,23,4,4,1,3,0,1,0
"kaggle:titanic","postDraw",1,0,0,0,0,0,0,0,0,0,0,0,0,0,0,0,0,0
"kaggle:titanic","drawGTree",41,27,27,1,26,26,1,0,0,0,23,3,4,0,4,0,0,0
"kaggle:titanic","preDraw",1,0,0,0,0,0,0,0,0,0,0,0,0,0,0,0,0,0
"kaggle:titanic","NextMethod",4,1,1,0,1,1,0,0,0,0,0,1,1,0,1,0,0,0
"kaggle:titanic","set.gpar",133,59,57,13,46,42,13,0,0,4,38,6,15,1,14,1,0,0
"kaggle:titanic","unique.default",52,6,6,0,6,1,0,0,0,5,6,0,2,0,2,0,0,0
"kaggle:titanic","current.vpPath",44,29,29,7,22,22,3,4,0,0,19,3,2,1,1,0,1,0
"kaggle:titanic","vpPathFromVector",88,35,34,7,28,21,3,4,0,7,21,5,6,1,5,0,1,0
"kaggle:titanic","strsplit",7,6,3,2,4,1,0,2,0,3,4,0,1,1,0,0,1,0
"kaggle:titanic","formals",10,5,3,0,5,3,0,0,0,2,2,1,2,0,2,0,0,0
"kaggle:titanic","is.ordered",5,5,5,1,4,2,1,0,0,2,0,2,3,0,3,0,0,0
"kaggle:titanic","FUN",11,10,7,3,7,2,0,3,0,5,6,0,1,0,1,0,0,0
"kaggle:titanic","FUN",6,5,5,1,4,4,0,1,0,0,2,2,0,0,0,0,0,0
"kaggle:titanic","lockEnvironment",2,2,2,0,2,1,0,0,0,1,0,1,1,0,1,0,0,0
"kaggle:titanic","eval_bare",8,4,4,0,4,4,0,0,0,0,0,4,1,0,1,0,0,0
"kaggle:titanic","FUN",5,2,2,0,2,2,0,0,0,0,0,2,0,0,0,0,0,0
"kaggle:titanic","is_formula",9,5,5,1,4,4,1,0,0,0,0,4,2,0,2,0,0,0
"kaggle:titanic","new.env",4,4,3,3,1,0,1,2,0,1,0,0,2,2,0,0,2,0
"kaggle:titanic","ggproto",65,25,24,6,19,15,4,2,0,4,14,4,8,3,5,1,2,0
"kaggle:titanic","quo_get_expr",5,3,3,0,3,3,0,0,0,0,0,3,1,0,1,0,0,0
"kaggle:titanic","is_string",7,4,4,1,3,3,1,0,0,0,0,3,2,0,2,0,0,0
"kaggle:titanic","get_expr",8,5,5,0,5,5,0,0,0,0,3,2,4,0,4,0,0,0
"kaggle:titanic","get",6,6,6,1,5,5,0,1,0,0,2,3,4,1,3,0,1,0
"kaggle:titanic","unknown--fromConstant",45,18,18,4,14,12,2,2,0,2,10,2,6,0,6,0,0,0
"kaggle:titanic","strip_dots",106,55,52,10,45,39,5,5,0,6,33,8,12,1,11,0,1,0
"kaggle:titanic","ggproto_formals",5,4,4,0,4,4,0,0,0,0,0,4,0,0,0,0,0,0
"kaggle:titanic","as.vector",2,2,2,0,2,2,0,0,0,0,0,2,1,0,1,0,0,0
"kaggle:titanic","names2",7,4,4,0,4,4,0,0,0,0,2,2,1,0,1,0,0,0
"kaggle:titanic","new_quosure",8,4,4,0,4,4,0,0,0,0,0,4,1,0,1,0,0,0
"kaggle:titanic","inject",10,5,4,0,5,3,0,0,0,2,2,2,1,0,1,0,0,0
"kaggle:titanic","every",95,32,32,5,27,27,5,0,0,0,23,4,9,0,9,0,0,0
"kaggle:titanic","is_symbolic",8,8,8,2,6,6,2,0,0,0,2,4,5,1,4,1,0,0
"kaggle:titanic","union",6,6,6,0,6,6,0,0,0,0,6,0,0,0,0,0,0,0
"kaggle:titanic","caller_env",3,3,3,0,3,3,0,0,0,0,2,1,0,0,0,0,0,0
"kaggle:titanic","allow_lambda",14,8,8,2,6,6,2,0,0,0,2,4,4,0,4,0,0,0
"kaggle:titanic","element_line",87,54,52,11,43,33,7,4,0,10,35,8,13,2,11,0,2,0
"kaggle:titanic","is_theme_element",18,16,15,4,12,7,4,0,0,5,8,2,5,0,5,0,0,0
"kaggle:titanic","is_theme",5,5,5,1,4,2,1,0,0,2,0,2,2,0,2,0,0,0
"kaggle:titanic","element_rect",85,52,50,11,41,31,7,4,0,10,32,9,13,2,11,0,2,0
"kaggle:titanic","",8,4,4,2,2,1,0,2,0,1,2,0,0,0,0,0,0,0
"kaggle:titanic","new.env",4,4,3,3,1,0,1,2,0,1,0,0,2,2,0,0,2,0
"kaggle:titanic","get",6,6,6,1,5,5,0,1,0,0,2,3,4,1,3,0,1,0
"kaggle:titanic","create_super_env",130,51,51,7,44,41,1,6,0,3,40,4,1,0,1,0,0,0
"kaggle:titanic","get0",6,6,6,1,5,5,0,1,0,0,0,5,3,1,2,0,1,0
"kaggle:titanic","getHook",4,4,4,0,4,4,0,0,0,0,2,2,0,0,0,0,0,0
"kaggle:titanic","new.env",4,4,3,3,1,0,1,2,0,1,0,0,2,2,0,0,2,0
"kaggle:titanic","get",6,6,6,1,5,5,0,1,0,0,2,3,4,1,3,0,1,0
"kaggle:titanic","eval",8,7,3,1,6,2,0,0,1,4,5,1,2,1,1,0,0,1
"kaggle:titanic","lockEnvironment",2,2,2,1,1,1,0,1,0,0,0,1,1,1,0,0,1,0
"kaggle:titanic","",306,127,124,33,94,80,17,16,0,14,85,7,6,0,6,0,0,0
"kaggle:titanic","create_super_env",130,51,51,7,44,41,1,6,0,3,40,4,1,0,1,0,0,0
"kaggle:titanic","lockBinding",8,7,7,1,6,5,0,1,0,1,3,3,0,0,0,0,0,0
"kaggle:titanic","lockBinding",8,7,7,1,6,4,0,1,0,2,3,2,0,0,0,0,0,0
"kaggle:titanic","by_layer",36,23,22,2,21,19,1,1,0,2,16,3,1,0,1,0,0,0
"kaggle:titanic","try_fetch",6,4,4,1,3,2,0,1,0,1,1,1,1,0,1,0,0,0
"kaggle:titanic","defaults",47,30,30,0,30,30,0,0,0,0,28,2,16,0,16,0,0,0
"kaggle:titanic","vec_ptype",11,5,5,0,5,5,0,0,0,0,0,5,0,0,0,0,0,0
"kaggle:titanic","vec_set_names",7,4,4,0,4,4,0,0,0,0,2,2,0,0,0,0,0,0
"kaggle:titanic","is_atomic",7,4,4,1,3,3,1,0,0,0,0,3,1,0,1,0,0,0
"kaggle:titanic","accessor",1,1,1,1,0,0,0,1,0,0,0,0,1,1,0,0,1,0
"kaggle:titanic","accessor",1,1,1,1,0,0,0,1,0,0,0,0,1,1,0,0,1,0
"kaggle:titanic","frame_get",42,35,35,3,32,31,3,0,0,1,26,6,4,0,4,0,0,0
"kaggle:titanic","call2",7,4,4,0,4,4,0,0,0,0,0,4,1,0,1,0,0,0
"kaggle:titanic","sub",45,20,20,5,15,13,2,3,0,2,11,2,5,0,5,0,0,0
"kaggle:titanic","standardise_aes_names",65,29,28,7,22,19,4,3,0,3,17,5,5,1,4,1,0,0
"kaggle:titanic","env_bind0",12,5,5,0,5,4,0,0,0,1,2,3,3,0,3,0,0,0
"kaggle:titanic","get",6,6,6,1,5,5,0,1,0,0,2,3,4,1,3,0,1,0
"kaggle:titanic","warn_for_aes_extract_usage_expr",35,15,15,4,11,11,3,1,0,0,5,6,7,1,6,0,1,0
"kaggle:titanic","has_default_transform",20,18,18,2,16,10,2,0,0,6,13,3,2,0,2,0,0,0
"kaggle:titanic","FUN",20,18,18,2,16,10,2,0,0,6,14,2,4,0,4,0,0,0
"kaggle:titanic","has_default_transform",20,18,18,2,16,10,2,0,0,6,13,3,2,0,2,0,0,0
"kaggle:titanic","recursive_merge",12,9,9,0,9,9,0,0,0,0,6,3,3,0,3,0,0,0
"kaggle:titanic","get",6,6,6,1,5,5,0,1,0,0,2,3,4,1,3,0,1,0
"kaggle:titanic","assign_func_envs",4,3,3,0,3,3,0,0,0,0,0,3,1,0,1,0,0,0
"kaggle:titanic","split_with_index",25,17,15,2,15,13,1,1,0,2,10,5,0,0,0,0,0,0
"kaggle:titanic","vec_size",7,4,4,1,3,3,1,0,0,0,0,3,1,0,1,0,0,0
"kaggle:titanic","vec_cast",14,5,5,0,5,5,0,0,0,0,3,2,3,0,3,0,0,0
"kaggle:titanic","vec_ptype",11,5,5,0,5,5,0,0,0,0,2,3,2,0,2,0,0,0
"kaggle:titanic","vec_assert",72,42,41,6,36,25,6,0,0,11,31,5,17,0,17,0,0,0
"kaggle:titanic","is_same_type",40,30,24,3,27,21,3,0,0,6,23,4,14,0,14,0,0,0
"kaggle:titanic","expr",2,1,1,0,1,1,0,0,0,0,0,1,0,0,0,0,0,0
"kaggle:titanic","double",1,1,1,0,1,0,0,0,0,1,0,0,0,0,0,0,0,0
"kaggle:titanic","get",6,6,6,1,5,5,0,1,0,0,2,3,4,1,3,0,1,0
"kaggle:titanic","scale_apply",50,35,33,7,28,25,6,1,0,3,18,10,4,0,4,0,0,0
"kaggle:titanic","get_limits",54,8,8,1,7,7,1,0,0,0,4,3,0,0,0,0,0,0
"kaggle:titanic","vec_cast",14,7,7,0,7,7,0,0,0,0,4,3,3,0,3,0,0,0
"kaggle:titanic","accessor",1,1,1,1,0,0,0,1,0,0,0,0,1,1,0,0,1,0
"kaggle:titanic","replace",4,4,4,2,2,2,1,1,0,0,2,0,0,0,0,0,0,0
"kaggle:titanic","FUN",8,8,7,2,6,3,1,1,0,3,5,1,0,0,0,0,0,0
"kaggle:titanic","make.unique",2,2,2,1,1,1,0,1,0,0,0,1,0,0,0,0,0,0
"kaggle:titanic","clii__vspace",54,4,4,2,2,2,2,0,0,0,0,2,0,0,0,0,0,0
"kaggle:titanic","get",6,6,6,1,5,5,0,1,0,0,2,3,4,1,3,0,1,0
"kaggle:titanic","make_ansi_style",96,62,62,13,49,40,5,8,0,9,45,2,13,0,13,0,0,0
"kaggle:titanic","create_ansi_style",94,61,59,9,52,47,4,5,0,5,46,6,15,2,13,0,2,0
"kaggle:titanic","ansi_style_from_r_color",25,19,19,4,15,15,1,3,0,0,10,5,1,1,0,0,1,0
"kaggle:titanic","ansi256",109,38,38,14,24,23,8,6,0,1,19,5,0,0,0,0,0,0
"kaggle:titanic","create_formatter",90,61,42,20,41,33,17,3,0,8,38,3,19,1,18,1,0,0
"kaggle:titanic","merge_embedded_styles",112,66,63,16,50,45,12,4,0,5,47,1,28,1,27,0,1,0
"kaggle:titanic","",1,0,0,0,0,0,0,0,0,0,0,0,0,0,0,0,0,0
"kaggle:titanic","last",6,4,4,1,3,3,0,1,0,0,2,1,3,1,2,0,1,0
"kaggle:titanic","%||%",3,3,3,0,3,2,0,0,0,1,3,0,3,0,3,0,0,0
"kaggle:titanic","",8,5,5,1,4,4,0,1,0,0,2,2,0,0,0,0,0,0
"kaggle:titanic","call_if_fun",11,10,8,1,9,6,1,0,0,3,2,4,3,1,2,1,0,0
"kaggle:titanic","substring",38,23,23,11,12,10,4,7,0,2,11,1,8,6,2,0,6,0
"kaggle:titanic","ansi_strip",33,17,17,1,16,16,0,1,0,0,15,1,0,0,0,0,0,0
"kaggle:titanic","rep.int",2,2,2,1,1,1,0,1,0,0,0,1,2,1,1,0,1,0
"kaggle:titanic","vapply",15,9,9,0,9,9,0,0,0,0,6,3,6,0,6,0,0,0
"kaggle:titanic","get",6,6,6,1,5,5,0,1,0,0,2,3,4,1,3,0,1,0
"kaggle:titanic","clii__container_end",308,100,99,12,88,83,10,2,0,5,67,19,9,1,8,1,0,0
"kaggle:titanic","FUN",12,7,6,1,6,2,1,0,0,4,5,1,3,0,3,0,0,0
"kaggle:titanic","is_yes",8,8,8,2,6,6,2,0,0,0,4,2,4,1,3,1,0,0
"kaggle:titanic","vapply",15,9,9,0,9,9,0,0,0,0,6,3,6,0,6,0,0,0
"kaggle:titanic","get",6,6,6,1,5,5,0,1,0,0,2,3,4,1,3,0,1,0
"kaggle:titanic","vlapply",5,5,5,0,5,5,0,0,0,0,2,3,0,0,0,0,0,0
"kaggle:titanic","get",6,6,6,1,5,5,0,1,0,0,2,3,4,1,3,0,1,0
"kaggle:titanic","viapply",5,5,5,0,5,5,0,0,0,0,0,5,0,0,0,0,0,0
"kaggle:titanic","%||%",4,4,4,0,4,3,0,0,0,1,3,1,3,0,3,0,0,0
"kaggle:titanic","is_character",7,4,4,1,3,3,1,0,0,0,0,3,2,0,2,0,0,0
"kaggle:titanic","unknown--fromConstant",5,4,4,0,4,3,0,0,0,1,2,2,0,0,0,0,0,0
"kaggle:titanic","vec_size",7,4,4,1,3,3,1,0,0,0,0,3,1,0,1,0,0,0
"kaggle:titanic","vec_cast",14,7,6,0,7,6,0,0,0,1,4,2,3,0,3,0,0,0
"kaggle:titanic","mapped_discrete",14,9,9,0,9,9,0,0,0,0,7,2,2,0,2,0,0,0
"kaggle:titanic","FUN",6,4,3,0,4,2,0,0,0,2,4,0,2,0,2,0,0,0
"kaggle:titanic","mostattributes<-",106,3,3,1,2,2,1,0,0,0,0,2,1,0,1,0,0,0
"kaggle:titanic","FUN",6,4,3,0,4,2,0,0,0,2,4,0,0,0,0,0,0,0
"kaggle:titanic","diff",1,0,0,0,0,0,0,0,0,0,0,0,0,0,0,0,0,0
"kaggle:titanic","FUN",5,3,3,1,2,2,1,0,0,0,0,2,1,0,1,0,0,0
"kaggle:titanic","FUN",5,3,3,1,2,2,1,0,0,0,0,2,1,0,1,0,0,0
"kaggle:titanic","get_expr",8,5,5,0,5,5,0,0,0,0,3,2,4,0,4,0,0,0
"kaggle:titanic","rep_len",2,2,2,1,1,1,0,1,0,0,0,1,2,1,1,0,1,0
"kaggle:titanic","lengths",2,2,2,0,2,2,0,0,0,0,0,2,1,0,1,0,0,0
"kaggle:titanic","unique",1,0,0,0,0,0,0,0,0,0,0,0,0,0,0,0,0,0
"kaggle:titanic","factor",93,55,55,15,40,37,10,5,0,3,33,6,20,3,17,1,2,0
"kaggle:titanic","FUN",34,26,26,5,21,19,4,1,0,2,13,6,6,0,6,0,0,0
"kaggle:titanic","is.discrete",13,11,11,3,8,6,3,0,0,2,1,5,5,0,5,0,0,0
"kaggle:titanic","get",6,6,6,1,5,5,0,1,0,0,2,3,4,1,3,0,1,0
"kaggle:titanic","FUN",39,25,25,5,20,19,4,1,0,1,15,5,3,0,3,0,0,0
"kaggle:titanic","",11,1,1,0,1,1,0,0,0,0,0,1,0,0,0,0,0,0
"kaggle:titanic","obj_is_vector",5,3,3,1,2,2,1,0,0,0,0,2,1,0,1,0,0,0
"kaggle:titanic","vec_ptype_finalise",6,3,3,0,3,3,0,0,0,0,2,1,2,0,2,0,0,0
"kaggle:titanic",".simplicity",38,29,29,9,20,20,9,0,0,0,19,1,0,0,0,0,0,0
"kaggle:titanic",".coverage",18,18,18,0,18,15,0,0,0,3,18,0,0,0,0,0,0,0
"kaggle:titanic",".density",34,24,24,0,24,18,0,0,0,6,24,0,0,0,0,0,0,0
"kaggle:titanic",".legibility",0,0,0,0,0,0,0,0,0,0,0,0,0,0,0,0,0,0
"kaggle:titanic",".simplicity.max",17,16,16,6,10,9,6,0,0,1,10,0,0,0,0,0,0,0
"kaggle:titanic","FUN",11,7,7,4,3,2,3,1,0,1,3,0,3,1,2,0,1,0
"kaggle:titanic","FUN",10,6,6,0,6,5,0,0,0,1,4,2,3,0,3,0,0,0
"kaggle:titanic","transform_position",54,43,43,10,33,33,3,7,0,0,31,2,8,3,5,1,2,0
"kaggle:titanic","do.call",9,9,9,1,8,8,0,1,0,0,5,3,3,1,2,0,1,0
"kaggle:titanic","get",6,6,6,1,5,5,0,1,0,0,2,3,4,1,3,0,1,0
"kaggle:titanic","quo_squash_impl",29,23,23,2,21,14,2,0,0,7,17,4,8,0,8,0,0,0
"kaggle:titanic","as_label",88,46,37,7,39,28,7,0,0,11,26,10,9,0,9,0,0,0
"kaggle:titanic","caller_arg",34,17,16,0,17,14,0,0,0,3,7,7,1,0,1,0,0,0
"kaggle:titanic","duplicate",7,4,4,0,4,4,0,0,0,0,2,2,0,0,0,0,0,0
"kaggle:titanic","arg_match0",12,5,5,0,5,5,0,0,0,0,2,3,1,0,1,0,0,0
"kaggle:titanic","current_env",1,1,1,0,1,1,0,0,0,0,0,1,0,0,0,0,0,0
"kaggle:titanic","check_arg",25,9,9,0,9,5,0,0,0,4,2,3,2,0,2,0,0,0
"kaggle:titanic","aes_to_scale",17,15,15,4,11,11,3,1,0,0,10,1,4,1,3,1,0,0
"kaggle:titanic","%||%",3,3,3,2,1,0,1,1,0,1,0,0,2,1,1,1,0,0
"kaggle:titanic","resolve_guide",24,21,21,2,19,15,2,0,0,4,13,4,13,0,13,0,0,0
"kaggle:titanic","new.env",4,4,3,3,1,0,1,2,0,1,0,0,2,2,0,0,2,0
"kaggle:titanic","get",6,6,6,1,5,5,0,1,0,0,2,3,4,1,3,0,1,0
"kaggle:titanic","exists",8,6,6,1,5,5,0,1,0,0,0,5,4,1,3,0,1,0
"kaggle:titanic","ggproto",65,25,24,6,19,15,4,2,0,4,14,4,8,3,5,1,2,0
"kaggle:titanic","new_guide",154,78,78,6,72,70,2,4,0,2,67,5,16,0,16,0,0,0
"kaggle:titanic","check_subclass",45,30,28,6,24,20,5,1,0,4,13,8,6,1,5,0,1,0
"kaggle:titanic","vec_cast",14,7,6,0,7,6,0,0,0,1,4,2,3,0,3,0,0,0
"kaggle:titanic","vec_assert",72,42,41,6,36,25,6,0,0,11,31,5,17,0,17,0,0,0
"kaggle:titanic","find_global",17,8,8,1,7,7,1,0,0,0,6,1,1,0,1,0,0,0
"kaggle:titanic","find_global",17,8,8,1,7,7,1,0,0,0,6,1,1,0,1,0,0,0
"kaggle:titanic","validate_guide",28,17,17,3,14,11,2,1,0,3,8,4,3,0,3,0,0,0
"kaggle:titanic","get",6,6,6,1,5,5,0,1,0,0,2,3,4,1,3,0,1,0
"kaggle:titanic","compact",8,7,7,1,6,6,1,0,0,0,4,2,0,0,0,0,0,0
"kaggle:titanic","as.matrix",1,0,0,0,0,0,0,0,0,0,0,0,0,0,0,0,0,0
"kaggle:titanic","is_empty",8,3,3,0,3,3,0,0,0,0,2,1,0,0,0,0,0,0
"kaggle:titanic","get",6,6,6,1,5,5,0,1,0,0,2,3,4,1,3,0,1,0
"kaggle:titanic","new_aes",81,36,33,9,27,22,5,4,0,5,22,4,12,2,10,0,2,0
"kaggle:titanic","match",4,4,4,0,4,4,0,0,0,0,2,2,3,0,3,0,0,0
"kaggle:titanic","FUN",10,6,6,0,6,5,0,0,0,1,4,2,3,0,3,0,0,0
"kaggle:titanic","FUN",28,18,18,5,13,11,5,0,0,2,5,6,11,1,10,1,0,0
"kaggle:titanic","aesthetics",60,25,25,2,23,22,0,2,0,1,21,2,2,0,2,0,0,0
"kaggle:titanic","label_ordinal",5,5,5,0,5,5,0,0,0,0,4,1,0,0,0,0,0,0
"kaggle:titanic","vec_cast",14,7,7,0,7,7,0,0,0,0,4,3,3,0,3,0,0,0
"kaggle:titanic","FUN",14,14,14,2,12,11,2,0,0,1,11,0,6,0,6,0,0,0
"kaggle:titanic","get",6,6,6,1,5,5,0,1,0,0,2,3,4,1,3,0,1,0
"kaggle:titanic","quo_squash_impl",29,23,16,2,21,14,2,0,0,7,17,4,8,0,8,0,0,0
"kaggle:titanic","quo_squash_impl",29,23,23,2,21,14,2,0,0,7,17,4,8,0,8,0,0,0
"kaggle:titanic","caller_arg",34,17,16,0,17,14,0,0,0,3,7,7,1,0,1,0,0,0
"kaggle:titanic","integer",1,1,1,0,1,1,0,0,0,0,0,1,1,0,1,0,0,0
"kaggle:titanic","make.names",20,18,18,4,14,11,1,3,0,3,11,2,0,0,0,0,0,0
"kaggle:titanic","transform_position",54,43,43,10,33,33,3,7,0,0,31,2,8,3,5,1,2,0
"kaggle:titanic","transform",16,12,12,0,12,12,0,0,0,0,12,0,0,0,0,0,0,0
"kaggle:titanic","as.matrix",1,0,0,0,0,0,0,0,0,0,0,0,0,0,0,0,0,0
"kaggle:titanic","",10,10,7,0,10,6,0,0,0,4,5,4,2,0,2,0,0,0
"kaggle:titanic","encode_c",46,33,26,8,25,19,7,1,1,6,19,5,10,2,8,1,1,1
"kaggle:titanic","is_linear",0,0,0,0,0,0,0,0,0,0,0,0,0,0,0,0,0,0
"kaggle:titanic","unit",54,34,34,10,24,22,8,2,0,2,17,5,9,1,8,1,0,0
"kaggle:titanic","ncol",4,3,3,1,2,2,1,0,0,0,0,2,1,0,1,0,0,0
"kaggle:titanic","",107,45,42,10,35,24,6,4,0,11,27,7,4,1,3,1,0,0
"kaggle:titanic","unknown--fromConstant",5,3,3,0,3,3,0,0,0,0,0,3,1,0,1,0,0,0
"kaggle:titanic","encode_c",46,33,26,8,25,19,7,1,1,6,19,5,10,2,8,1,1,1
"kaggle:titanic","alpha",109,40,35,7,33,23,2,5,0,10,26,5,13,3,10,0,3,0
"kaggle:titanic","check_linewidth",17,3,3,0,3,3,0,0,0,0,2,1,1,0,1,0,0,0
"kaggle:titanic","check_bool",16,6,6,1,5,4,1,0,0,1,3,1,0,0,0,0,0,0
"kaggle:titanic","unit",54,34,34,10,24,22,8,2,0,2,17,5,9,1,8,1,0,0
"kaggle:titanic","ggname",7,1,1,0,1,1,0,0,0,0,0,1,0,0,0,0,0,0
"kaggle:titanic","get",6,6,6,1,5,5,0,1,0,0,2,3,4,1,3,0,1,0
"kaggle:titanic","remove_missing",94,69,63,10,59,51,9,1,0,8,43,10,11,0,11,0,0,0
"kaggle:titanic","",8,6,6,0,6,6,0,0,0,0,4,2,0,0,0,0,0,0
"kaggle:titanic","logical",1,1,1,1,0,0,0,1,0,0,0,0,1,1,0,0,1,0
"kaggle:titanic","FUN",20,12,12,2,10,7,2,0,0,3,3,4,4,0,4,0,0,0
"kaggle:titanic","fill_alpha",38,4,4,1,3,3,0,1,0,0,2,1,4,1,3,0,1,0
"kaggle:titanic","rowSums",91,43,42,18,25,19,16,2,0,6,20,3,3,0,3,0,0,0
"kaggle:titanic","alpha",109,40,35,7,33,23,2,5,0,10,26,5,13,3,10,0,3,0
"kaggle:titanic","fill_alpha",38,4,4,1,3,3,0,1,0,0,2,1,4,1,3,0,1,0
"kaggle:titanic","FUN",11,7,7,4,3,3,3,1,0,0,3,0,3,1,2,0,1,0
"kaggle:titanic","character",1,1,1,0,1,1,0,0,0,0,0,1,1,0,1,0,0,0
"kaggle:titanic","get",6,6,6,1,5,5,0,1,0,0,2,3,4,1,3,0,1,0
"kaggle:titanic","detect_missing",47,39,38,5,34,31,5,0,0,3,27,5,8,0,8,0,0,0
"kaggle:titanic","modify_list",16,14,14,7,7,7,0,7,0,0,6,1,6,1,5,0,1,0
"kaggle:titanic","element_grob",1,0,0,0,0,0,0,0,0,0,0,0,0,0,0,0,0,0
"kaggle:titanic","get",6,6,6,1,5,5,0,1,0,0,2,3,4,1,3,0,1,0
"kaggle:titanic","calc_element",99,51,51,5,46,42,4,1,0,4,39,6,13,1,12,0,1,0
"kaggle:titanic","FUN",7,7,4,0,7,4,0,0,0,3,3,1,2,0,2,0,0,0
"kaggle:titanic","len0_null",5,4,4,2,2,1,2,0,0,1,0,1,0,0,0,0,0,0
"kaggle:titanic","vec_recycle",10,5,5,1,4,4,1,0,0,0,1,3,0,0,0,0,0,0
"kaggle:titanic","unit",54,34,34,10,24,22,8,2,0,2,17,5,9,1,8,1,0,0
"kaggle:titanic","unit",54,34,34,10,24,22,8,2,0,2,17,5,9,1,8,1,0,0
"kaggle:titanic","upgradeUnit",9,8,8,2,6,4,2,0,0,2,2,2,5,0,5,0,0,0
"kaggle:titanic","convertUnit",49,46,44,9,37,35,9,0,0,2,34,3,4,0,4,0,0,0
"kaggle:titanic","valid.units",5,3,3,1,2,2,1,0,0,0,0,2,0,0,0,0,0,0
"kaggle:titanic","is_symbol",10,6,6,1,5,4,0,1,0,1,2,2,2,1,1,0,1,0
"kaggle:titanic",".set_row_names",6,5,5,0,5,3,0,0,0,2,2,2,1,0,1,0,0,0
"kaggle:titanic","grobWidth",1,0,0,0,0,0,0,0,0,0,0,0,0,0,0,0,0,0
"kaggle:titanic","check_unit",20,8,8,2,6,3,2,0,0,3,0,3,3,0,3,0,0,0
"kaggle:titanic","get",6,6,6,1,5,5,0,1,0,0,2,3,4,1,3,0,1,0
"kaggle:titanic","sapply",32,25,24,7,18,14,4,3,0,4,13,3,9,0,9,0,0,0
"kaggle:titanic","gList",28,17,17,3,14,12,3,0,0,2,11,3,6,0,6,0,0,0
"kaggle:titanic","gtable_add_cols",117,38,36,5,33,29,5,0,0,4,21,9,6,0,6,0,0,0
"kaggle:titanic","sys.parent",1,1,1,0,1,1,0,0,0,0,0,1,1,0,1,0,0,0
"kaggle:titanic","is_theme_complete",14,11,11,1,10,2,1,0,0,8,6,1,2,0,2,0,0,0
"kaggle:titanic","add_theme",63,51,43,5,46,37,5,0,0,9,41,2,4,0,4,0,0,0
"kaggle:titanic","is_theme_validate",17,13,3,1,12,2,1,0,0,10,8,1,2,0,2,0,0,0
"kaggle:titanic","is_theme_validate",20,16,16,1,15,2,1,0,0,13,11,1,5,0,5,0,0,0
"kaggle:titanic","merge_element",1,0,0,0,0,0,0,0,0,0,0,0,0,0,0,0,0,0
"kaggle:titanic","is.rel",5,5,5,1,4,2,1,0,0,2,0,2,3,0,3,0,0,0
"kaggle:titanic","is.subclass",44,33,33,5,28,26,3,2,0,2,21,6,15,1,14,0,1,0
"kaggle:titanic","xor",17,7,7,5,2,0,5,0,0,2,2,0,0,0,0,0,0,0
"kaggle:titanic","get",6,6,6,1,5,5,0,1,0,0,2,3,4,1,3,0,1,0
"kaggle:titanic","sapply",32,25,24,7,18,14,4,3,0,4,13,3,9,0,9,0,0,0
"kaggle:titanic","textGrob",44,33,33,3,30,28,3,0,0,2,21,7,9,0,9,0,0,0
"kaggle:titanic","unit",54,34,34,10,24,22,8,2,0,2,17,5,9,1,8,1,0,0
"kaggle:titanic","validGrob",1,0,0,0,0,0,0,0,0,0,0,0,0,0,0,0,0,0
"kaggle:titanic","convertUnit",49,46,41,8,38,36,8,0,0,2,34,4,6,1,5,1,0,0
"kaggle:titanic","rotate_just",137,93,58,34,59,41,33,1,0,18,53,4,4,0,4,0,0,0
"kaggle:titanic","vec_recycle",10,5,5,1,4,4,1,0,0,0,1,3,0,0,0,0,0,0
"kaggle:titanic","",11,8,8,4,4,3,3,1,0,1,1,3,0,0,0,0,0,0
"kaggle:titanic","titleGrob",344,210,207,27,183,166,26,1,0,17,165,15,47,2,45,1,1,0
"kaggle:titanic","font_descent",44,37,35,7,30,24,3,4,0,6,21,7,4,0,4,0,0,0
"kaggle:titanic","get",6,6,6,1,5,5,0,1,0,0,2,3,4,1,3,0,1,0
"kaggle:titanic","convertUnit",49,46,41,8,38,36,8,0,0,2,34,4,6,1,5,1,0,0
"kaggle:titanic","width_cm",29,25,25,8,17,15,8,0,0,2,5,10,8,0,8,0,0,0
"kaggle:titanic","as.graphicsAnnot",10,5,5,1,4,1,0,1,0,3,4,0,3,1,2,0,1,0
"kaggle:titanic","neg_to_pos",8,8,8,0,8,8,0,0,0,0,6,2,4,0,4,0,0,0
"kaggle:titanic","get",6,6,6,1,5,5,0,1,0,0,2,3,4,1,3,0,1,0
"kaggle:titanic","FUN",29,25,25,6,19,17,6,0,0,2,5,12,9,0,9,0,0,0
"kaggle:titanic","grobHeight",1,0,0,0,0,0,0,0,0,0,0,0,0,0,0,0,0,0
"kaggle:titanic","eval",8,7,3,1,6,2,1,0,0,4,4,2,3,1,2,1,0,0
"kaggle:titanic","check_number_whole",22,9,9,1,8,7,1,0,0,1,6,2,0,0,0,0,0,0
"kaggle:titanic","getClassDef",60,42,40,1,41,37,1,0,0,4,33,8,6,0,6,0,0,0
"kaggle:titanic","slot",7,4,4,0,4,4,0,0,0,0,0,4,1,0,1,0,0,0
"kaggle:titanic","is.zero",6,6,6,1,5,3,1,0,0,2,2,1,4,0,4,0,0,0
"kaggle:titanic","gtable_add_cols",117,38,36,5,33,29,5,0,0,4,20,10,7,0,7,0,0,0
"kaggle:titanic","get",6,6,6,1,5,5,0,1,0,0,2,3,4,1,3,0,1,0
"kaggle:titanic","f",105,52,52,16,36,34,14,2,0,2,28,6,10,0,10,0,0,0
"kaggle:titanic","arg_match0",12,5,5,0,5,5,0,0,0,0,2,3,1,0,1,0,0,0
"kaggle:titanic","nrow",4,3,3,1,2,2,1,0,0,0,0,2,1,0,1,0,0,0
"kaggle:titanic","valid.charjust",96,65,64,17,48,40,13,4,0,8,47,1,10,2,8,2,0,0
"kaggle:titanic","sort.int",244,99,97,36,63,53,18,18,0,10,59,2,24,9,15,1,8,0
"kaggle:titanic",".doSortWrap",40,22,22,11,11,10,7,4,0,1,10,1,2,2,0,0,2,0
"kaggle:titanic",".makeSortEnum",13,5,4,3,2,2,3,0,0,0,2,0,0,0,0,0,0,0
"kaggle:titanic","matrix",13,11,7,0,11,3,0,0,0,8,10,0,5,0,5,0,0,0
"kaggle:titanic","FUN",1,0,0,0,0,0,0,0,0,0,0,0,0,0,0,0,0,0
"kaggle:titanic","NCOL",9,6,6,3,3,3,2,1,0,0,1,2,2,1,1,0,1,0
"kaggle:titanic","sym",39,27,27,4,23,14,4,0,0,9,14,7,6,0,6,0,0,0
"kaggle:titanic","is_symbolic",8,8,8,2,6,6,2,0,0,0,2,4,5,1,4,1,0,0
"kaggle:titanic","is_call",11,6,6,1,5,5,1,0,0,0,2,3,4,0,4,0,0,0
"kaggle:titanic","node_cdr",5,3,3,0,3,3,0,0,0,0,0,3,2,0,2,0,0,0
"kaggle:titanic","f",5,3,3,1,2,2,1,0,0,0,0,2,0,0,0,0,0,0
"kaggle:titanic","duplicated",1,0,0,0,0,0,0,0,0,0,0,0,0,0,0,0,0,0
"kaggle:titanic","rename_aes",87,43,42,11,32,29,6,5,0,3,25,7,6,1,5,1,0,0
"kaggle:titanic","quo_squash_impl",29,23,16,2,21,14,2,0,0,7,17,4,8,0,8,0,0,0
"kaggle:titanic","quo_squash_impl",29,23,23,2,21,14,2,0,0,7,17,4,8,0,8,0,0,0
"kaggle:titanic","quo_squash",26,22,22,4,18,9,4,0,0,9,13,3,6,0,6,0,0,0
"kaggle:titanic","is_bare_formula",25,9,9,2,7,7,2,0,0,0,1,6,3,0,3,0,0,0
"kaggle:titanic","is_false",10,10,10,1,9,2,1,0,0,7,8,1,3,0,3,0,0,0
"kaggle:titanic","setdiff",20,16,16,0,16,16,0,0,0,0,12,4,13,0,13,0,0,0
"kaggle:titanic","accessor",1,1,1,1,0,0,0,1,0,0,0,0,1,1,0,0,1,0
"kaggle:titanic","frame_get",42,36,34,3,33,30,3,0,0,3,28,4,4,0,4,0,0,0
"kaggle:titanic","frame_call",24,11,10,0,11,8,0,0,0,3,2,6,2,0,2,0,0,0
"kaggle:titanic","get",6,6,6,1,5,5,0,1,0,0,2,3,4,1,3,0,1,0
"kaggle:titanic","strip_dots",106,59,56,12,47,41,7,5,0,6,35,8,16,1,15,0,1,0
"kaggle:titanic","defaults",47,30,25,0,30,25,0,0,0,5,26,4,19,0,19,0,0,0
"kaggle:titanic","FUN",14,11,11,4,7,4,4,0,0,3,3,2,4,1,3,1,0,0
"kaggle:titanic","eval_bare",8,5,4,0,5,3,0,0,0,2,2,2,1,0,1,0,0,0
"kaggle:titanic","element_blank",58,29,27,8,21,18,4,4,0,3,17,4,6,2,4,0,2,0
"kaggle:titanic","margin",13,8,1,0,8,0,0,0,0,8,6,0,0,0,0,0,0,0
"kaggle:titanic","new.env",4,4,3,3,1,0,1,2,0,1,0,0,2,2,0,0,2,0
"kaggle:titanic","clone",10,2,2,0,2,2,0,0,0,0,2,0,0,0,0,0,0,0
"kaggle:titanic","FUN",14,8,8,3,5,4,2,1,0,1,3,2,3,0,3,0,0,0
"kaggle:titanic","",7,4,4,1,3,3,1,0,0,0,0,3,1,0,1,0,0,0
"kaggle:titanic","is_column_vec",10,5,5,2,3,2,1,1,0,1,1,2,1,0,1,0,0,0
"kaggle:titanic","is.factor",5,5,5,1,4,2,1,0,0,2,0,2,3,0,3,0,0,0
"kaggle:titanic","is.discrete",8,6,6,2,4,4,2,0,0,0,1,3,2,0,2,0,0,0
"kaggle:titanic","sys.calls",0,0,0,0,0,0,0,0,0,0,0,0,0,0,0,0,0,0
"kaggle:titanic","",14,8,8,1,7,5,0,1,0,2,6,1,3,0,3,0,0,0
"kaggle:titanic","get",6,6,6,1,5,5,0,1,0,0,2,3,4,1,3,0,1,0
"kaggle:titanic","drop_null",10,6,6,1,5,5,1,0,0,0,3,2,4,1,3,1,0,0
"kaggle:titanic","modifyList",153,61,61,21,40,38,4,17,0,2,39,1,24,6,18,2,4,0
"kaggle:titanic","",57,7,7,2,5,5,2,0,0,0,0,5,0,0,0,0,0,0
"kaggle:titanic","setdiff",20,16,16,0,16,16,0,0,0,0,11,5,13,0,13,0,0,0
"kaggle:titanic","get",6,6,6,1,5,5,0,1,0,0,2,3,4,1,3,0,1,0
"kaggle:titanic","",481,165,160,58,107,79,40,18,0,28,94,7,12,4,8,0,4,0
"kaggle:titanic","%||%",4,4,4,2,2,1,2,0,0,1,1,1,3,2,1,2,0,0
"kaggle:titanic","FUN",6,4,4,0,4,4,0,0,0,0,2,2,0,0,0,0,0,0
"kaggle:titanic","flip_data",28,17,15,1,16,3,1,0,0,13,12,1,5,0,5,0,0,0
"kaggle:titanic","diff",1,0,0,0,0,0,0,0,0,0,0,0,0,0,0,0,0,0
"kaggle:titanic","expand_range",15,14,14,7,7,7,7,0,0,0,7,0,0,0,0,0,0,0
"kaggle:titanic","get",6,6,6,1,5,5,0,1,0,0,2,3,4,1,3,0,1,0
"kaggle:titanic","empty",22,20,18,6,14,12,6,0,0,2,6,6,5,0,5,0,0,0
"kaggle:titanic","",46,20,20,6,14,14,3,3,0,0,11,3,2,1,1,0,1,0
"kaggle:titanic","new.env",4,4,3,3,1,0,1,2,0,1,0,0,2,2,0,0,2,0
"kaggle:titanic","list2env",14,13,13,1,12,12,0,1,0,0,12,0,2,1,1,0,1,0
"kaggle:titanic","as_environment",23,13,13,2,11,10,2,0,0,1,5,5,5,0,5,0,0,0
"kaggle:titanic","detect_void_name",10,5,5,2,3,3,1,1,0,0,3,0,5,2,3,1,1,0
"kaggle:titanic","as_quosure",72,37,37,8,29,27,8,0,0,2,10,17,16,1,15,1,0,0
"kaggle:titanic","FUN",15,8,8,2,6,6,2,0,0,0,2,4,3,0,3,0,0,0
"kaggle:titanic","frame_get",42,36,34,3,33,30,3,0,0,3,28,4,4,0,4,0,0,0
"kaggle:titanic","frame_call",24,11,10,0,11,8,0,0,0,3,2,6,2,0,2,0,0,0
"kaggle:titanic","caller_call",28,15,14,1,14,13,1,0,0,1,10,4,1,0,1,0,0,0
"kaggle:titanic","vapply",15,9,9,0,9,9,0,0,0,0,6,3,6,0,6,0,0,0
"kaggle:titanic","get",6,6,6,1,5,5,0,1,0,0,2,3,4,1,3,0,1,0
"kaggle:titanic","is_calculated_aes",5,4,4,0,4,4,0,0,0,0,0,4,0,0,0,0,0,0
"kaggle:titanic","input",32,9,9,0,9,8,0,0,0,1,7,2,4,0,4,0,0,0
"kaggle:titanic","setdiff",20,16,16,0,16,16,0,0,0,0,11,5,13,0,13,0,0,0
"kaggle:titanic","FUN",7,6,6,0,6,6,0,0,0,0,2,4,2,0,2,0,0,0
"kaggle:titanic","lapply",15,14,14,0,14,14,0,0,0,0,11,3,9,0,9,0,0,0
"kaggle:titanic","vapply",17,11,10,0,11,9,0,0,0,2,6,3,7,0,7,0,0,0
"kaggle:titanic","get",6,6,6,1,5,5,0,1,0,0,2,3,4,1,3,0,1,0
"kaggle:titanic","check_required_aesthetics",94,41,38,5,36,29,4,1,0,7,33,2,16,2,14,1,1,0
"kaggle:titanic","get",6,6,6,1,5,5,0,1,0,0,2,3,4,1,3,0,1,0
"kaggle:titanic","new_transform",90,53,51,8,45,42,4,4,0,3,42,3,6,2,4,0,2,0
"kaggle:titanic","transform_identity",1,1,1,0,1,1,0,0,0,0,0,1,0,0,0,0,0,0
"kaggle:titanic","extended_breaks",1,1,1,0,1,0,0,0,0,1,0,0,0,0,0,0,0,0
"kaggle:titanic","seq",1,0,0,0,0,0,0,0,0,0,0,0,0,0,0,0,0,0
"kaggle:titanic","regular_minor_breaks",0,0,0,0,0,0,0,0,0,0,0,0,0,0,0,0,0,0
"kaggle:titanic","format_format",1,1,0,0,1,0,0,0,0,1,0,0,0,0,0,0,0,0
"kaggle:titanic","is_discrete",0,0,0,0,0,0,0,0,0,0,0,0,0,0,0,0,0,0
"kaggle:titanic","censor",32,20,20,6,14,10,3,1,2,4,12,1,3,2,1,0,0,2
"kaggle:titanic","inherits",3,3,3,0,3,3,0,0,0,0,0,3,2,0,2,0,0,0
"kaggle:titanic","is_guide",5,5,5,1,4,2,1,0,0,2,0,2,2,0,2,0,0,0
"kaggle:titanic","new.env",4,4,3,3,1,0,1,2,0,1,0,0,2,2,0,0,2,0
"kaggle:titanic","ggproto",65,25,24,6,19,15,4,2,0,4,14,4,8,3,5,1,2,0
"kaggle:titanic","new_guide",154,78,78,6,72,70,2,4,0,2,64,8,19,0,19,0,0,0
"kaggle:titanic","check_subclass",45,30,28,6,24,20,5,1,0,4,13,8,6,1,5,0,1,0
"kaggle:titanic","FUN",125,79,78,15,64,57,13,2,0,7,50,11,29,1,28,1,0,0
"kaggle:titanic","fun",21,7,7,0,7,7,0,0,0,0,5,2,0,0,0,0,0,0
"kaggle:titanic","as_string",30,19,19,2,17,14,2,0,0,3,8,7,5,0,5,0,0,0
"kaggle:titanic","transform",16,12,12,0,12,12,0,0,0,0,12,0,0,0,0,0,0,0
"kaggle:titanic","is_list",7,4,4,1,3,3,1,0,0,0,2,1,1,0,1,0,0,0
"kaggle:titanic","vapply",15,9,9,0,9,9,0,0,0,0,6,3,6,0,6,0,0,0
"kaggle:titanic","get",6,6,6,1,5,5,0,1,0,0,2,3,4,1,3,0,1,0
"kaggle:titanic","is_scaled_aes",4,4,4,0,4,4,0,0,0,0,0,4,0,0,0,0,0,0
"kaggle:titanic","get",6,6,6,1,5,5,0,1,0,0,2,3,4,1,3,0,1,0
"kaggle:titanic","is_staged_aes",4,4,4,0,4,4,0,0,0,0,0,4,1,0,1,0,0,0
"kaggle:titanic","check_aesthetics",21,10,10,5,5,3,5,0,0,2,4,1,0,0,0,0,0,0
"kaggle:titanic","FUN",33,24,24,7,17,15,7,0,0,2,6,9,11,1,10,1,0,0
"kaggle:titanic","get_breaks",3,2,2,0,2,2,0,0,0,0,0,2,1,0,1,0,0,0
"kaggle:titanic","arg_match0",12,5,5,0,5,5,0,0,0,0,2,3,1,0,1,0,0,0
"kaggle:titanic","names2",7,4,4,0,4,4,0,0,0,0,2,2,1,0,1,0,0,0
"kaggle:titanic","unknown--fromConstant",13,6,5,0,6,5,0,0,0,1,2,3,1,0,1,0,0,0
"kaggle:titanic","endots",214,57,57,13,44,35,8,5,0,9,36,8,10,0,10,0,0,0
"kaggle:titanic","FUN",50,28,28,2,26,17,1,1,0,9,18,6,5,0,5,0,0,0
"kaggle:titanic","get",6,6,6,1,5,5,0,1,0,0,2,3,4,1,3,0,1,0
"kaggle:titanic","calc_element",99,51,51,5,46,42,4,1,0,4,39,6,13,1,12,0,1,0
"kaggle:titanic","convertHeight",4,4,4,0,4,4,0,0,0,0,0,4,1,0,1,0,0,0
"kaggle:titanic","check_string",37,12,12,3,9,7,3,0,0,2,3,5,2,0,2,0,0,0
"kaggle:titanic","NCOL",9,6,6,2,4,4,2,0,0,0,1,3,2,0,2,0,0,0
"kaggle:titanic","is.zero",6,6,4,1,5,3,1,0,0,2,2,1,4,0,4,0,0,0
"kaggle:titanic","FUN",3,3,3,1,2,2,1,0,0,0,2,0,0,0,0,0,0,0
"kaggle:titanic","unknown--fromConstant",12,7,7,0,7,7,0,0,0,0,4,3,2,0,2,0,0,0
"kaggle:titanic","find_panel",23,5,5,0,5,5,0,0,0,0,4,1,0,0,0,0,0,0
"kaggle:titanic","gtable_add_rows",117,38,36,5,33,29,5,0,0,4,20,10,8,0,8,0,0,0
"kaggle:titanic","gtable_add_cols",117,38,36,5,33,29,5,0,0,4,20,10,7,0,7,0,0,0
"kaggle:titanic","valid.layout",93,43,36,7,36,23,5,2,0,13,30,5,8,0,8,0,0,0
"kaggle:titanic","vpname",22,16,14,0,16,14,0,0,0,2,12,2,1,0,1,0,0,0
"kaggle:titanic","NCOL",9,6,5,3,3,3,2,1,0,0,1,2,2,1,1,0,1,0
"kaggle:titanic","colnames",28,19,19,4,15,10,3,1,0,5,5,7,8,1,7,0,1,0
"kaggle:titanic","NCOL",9,6,5,3,3,3,2,1,0,0,1,2,2,1,1,0,1,0
"kaggle:titanic","colnames",28,19,19,4,15,10,3,1,0,5,5,7,8,1,7,0,1,0
"kaggle:titanic","formula",1,0,0,0,0,0,0,0,0,0,0,0,0,0,0,0,0,0
"kaggle:titanic","FUN",25,24,24,2,22,14,2,0,0,8,19,1,4,0,4,0,0,0
"kaggle:titanic","as.data.frame",4,1,1,0,1,1,0,0,0,0,0,1,1,0,1,0,0,0
"kaggle:titanic","apply",375,137,134,64,73,49,37,27,0,24,66,3,55,27,28,2,25,0
"kaggle:titanic","get",6,6,6,1,5,5,0,1,0,0,2,3,4,1,3,0,1,0
"kaggle:titanic","levels",1,0,0,0,0,0,0,0,0,0,0,0,0,0,0,0,0,0
"kaggle:titanic","FUN",5,3,3,2,1,1,1,1,0,0,0,1,1,1,0,0,1,0
"kaggle:titanic","substring",38,23,23,12,11,9,4,8,0,2,9,2,11,8,3,0,8,0
"kaggle:titanic","row.names<-",1,0,0,0,0,0,0,0,0,0,0,0,0,0,0,0,0,0
"kaggle:titanic","as.data.frame",4,1,1,0,1,1,0,0,0,0,0,1,1,0,1,0,0,0
"kaggle:titanic","matrix",13,11,10,0,11,9,0,0,0,2,10,1,6,0,6,0,0,0
"kaggle:titanic","row.names",1,0,0,0,0,0,0,0,0,0,0,0,0,0,0,0,0,0
"kaggle:titanic","deparse",11,11,7,1,10,6,1,0,0,4,9,0,2,0,2,0,0,0
"kaggle:titanic","is.ordered",5,5,3,1,4,2,1,0,0,2,0,2,3,0,3,0,0,0
"kaggle:titanic","array",53,7,7,3,4,1,1,2,0,3,4,0,5,3,2,1,2,0
"kaggle:titanic","var",41,30,28,6,24,14,6,0,0,10,15,5,6,0,6,0,0,0
"kaggle:titanic","FUN",363,42,40,11,31,22,7,4,0,9,24,3,3,0,3,0,0,0
"kaggle:titanic","mode",16,13,12,4,9,6,1,3,1,3,7,2,4,2,2,1,1,1
"kaggle:titanic","data.class",19,11,11,4,7,5,2,2,0,2,5,2,3,1,2,0,1,0
"kaggle:titanic","strrep",10,5,5,1,4,4,0,1,0,0,2,2,1,1,0,0,1,0
"kaggle:titanic","FUN",12,3,3,2,1,1,2,0,0,0,0,1,0,0,0,0,0,0
"kaggle:titanic","vapply",17,11,10,0,11,9,0,0,0,2,6,3,7,0,7,0,0,0
"kaggle:titanic","get",6,6,6,1,5,5,0,1,0,0,2,3,4,1,3,0,1,0
"kaggle:titanic",".identC",7,4,4,1,3,3,1,0,0,0,2,1,2,0,2,0,0,0
"kaggle:titanic",".identC",7,4,4,1,3,3,1,0,0,0,2,1,2,0,2,0,0,0
"kaggle:titanic","extends",116,72,72,23,49,44,15,8,0,5,44,4,9,2,7,2,0,0
"kaggle:titanic","possibleExtends",72,33,31,8,25,18,6,2,0,7,22,3,4,0,4,0,0,0
"kaggle:titanic","getClassDef",60,42,42,1,41,39,1,0,0,2,31,10,12,0,12,0,0,0
"kaggle:titanic","FUN",14,9,9,4,5,4,3,1,0,1,4,1,4,1,3,0,1,0
"kaggle:titanic","split",1,0,0,0,0,0,0,0,0,0,0,0,0,0,0,0,0,0
"kaggle:titanic","FUN",22,11,11,3,8,7,1,2,0,1,7,1,0,0,0,0,0,0
"kaggle:titanic","ifelse",105,58,57,25,33,23,14,11,0,10,28,3,27,14,13,6,8,0
"kaggle:titanic","makepredictcall",1,0,0,0,0,0,0,0,0,0,0,0,0,0,0,0,0,0
"kaggle:titanic","FUN",5,4,4,2,2,2,2,0,0,0,0,2,2,0,2,0,0,0
"kaggle:titanic","numeric",1,1,1,0,1,1,0,0,0,0,0,1,1,0,1,0,0,0
"kaggle:titanic","get",6,6,6,1,5,5,0,1,0,0,2,3,4,1,3,0,1,0
"kaggle:titanic","ctrfn",128,53,49,18,35,25,8,10,1,10,33,2,5,4,1,1,3,1
"kaggle:titanic","contrasts",67,30,30,7,23,15,7,0,0,8,19,3,2,1,1,1,0,0
"kaggle:titanic","mode",17,14,14,4,10,6,1,3,0,4,7,2,5,2,3,1,1,0
"kaggle:titanic","data.class",19,11,11,4,7,5,2,2,0,2,3,4,4,1,3,0,1,0
"kaggle:titanic","is",124,56,56,18,38,32,10,8,0,6,32,5,15,4,11,1,3,0
"kaggle:titanic","getClassDef",60,42,42,1,41,39,1,0,0,2,31,10,12,0,12,0,0,0
"kaggle:titanic","getClassDef",60,42,40,1,41,37,1,0,0,4,31,10,12,0,12,0,0,0
"kaggle:titanic",".requirePackage",43,12,11,2,10,7,1,1,0,3,9,1,0,0,0,0,0,0
"kaggle:titanic","FUN",4,3,3,0,3,3,0,0,0,0,2,1,2,0,2,0,0,0
"kaggle:titanic","FUN",4,3,3,0,3,3,0,0,0,0,2,1,0,0,0,0,0,0
"kaggle:titanic","FUN",4,3,3,0,3,3,0,0,0,0,2,1,0,0,0,0,0,0
"kaggle:titanic","FUN",4,3,3,0,3,3,0,0,0,0,2,1,0,0,0,0,0,0
"kaggle:titanic","FUN",4,3,3,0,3,3,0,0,0,0,2,1,0,0,0,0,0,0
"kaggle:titanic","FUN",4,3,3,0,3,3,0,0,0,0,2,1,0,0,0,0,0,0
"kaggle:titanic","FUN",4,3,3,0,3,3,0,0,0,0,2,1,0,0,0,0,0,0
"kaggle:titanic","FUN",4,3,3,0,3,3,0,0,0,0,2,1,0,0,0,0,0,0
"kaggle:titanic","FUN",4,3,3,0,3,3,0,0,0,0,2,1,0,0,0,0,0,0
"kaggle:titanic","FUN",22,11,11,3,8,7,1,2,0,1,6,2,0,0,0,0,0,0
"kaggle:titanic","FUN",4,3,3,0,3,3,0,0,0,0,2,1,0,0,0,0,0,0
"kaggle:titanic","URapply",17,14,14,3,11,11,1,2,0,0,7,4,2,0,2,0,0,0
"kaggle:titanic","unlist",27,24,24,0,24,23,0,0,0,1,21,3,2,0,2,0,0,0
"kaggle:titanic","structure",55,26,23,8,18,15,4,4,0,3,17,1,6,2,4,0,2,0
"kaggle:titanic","FUN",38,14,14,1,13,13,1,0,0,0,7,6,0,0,0,0,0,0
"kaggle:titanic","sample.int",16,13,13,0,13,13,0,0,0,0,13,0,0,0,0,0,0,0
"kaggle:titanic","formula",1,0,0,0,0,0,0,0,0,0,0,0,0,0,0,0,0,0
"kaggle:titanic","is.ordered",5,5,5,1,4,2,1,0,0,2,0,2,3,0,3,0,0,0
"kaggle:titanic","rep.int",2,2,2,2,0,0,1,1,0,0,0,0,2,2,0,1,1,0
"kaggle:titanic","array",53,14,14,6,8,3,0,5,1,5,8,0,6,4,2,0,3,1
"kaggle:titanic","sample",35,17,17,2,15,15,2,0,0,0,12,3,2,0,2,0,0,0
"kaggle:titanic","sample.int",16,13,13,0,13,13,0,0,0,0,13,0,0,0,0,0,0,0
"kaggle:titanic","FUN",3,3,3,0,3,3,0,0,0,0,0,3,2,0,2,0,0,0
"kaggle:titanic","sample.int",16,13,13,0,13,13,0,0,0,0,13,0,0,0,0,0,0,0
"kaggle:titanic","str2lang",1,1,1,0,1,1,0,0,0,0,0,1,0,0,0,0,0,0
"kaggle:titanic","FUN",5,4,4,2,2,2,2,0,0,0,0,2,2,0,2,0,0,0
"kaggle:titanic","isTRUE",11,8,5,4,4,3,4,0,0,1,3,1,2,1,1,1,0,0
"kaggle:titanic","isSymmetric.matrix",93,55,55,11,44,36,10,1,0,8,42,2,0,0,0,0,0,0
"kaggle:titanic","withOneRestart",26,15,15,1,14,13,0,1,0,1,12,2,0,0,0,0,0,0
"kaggle:titanic","",17,15,15,4,11,10,3,1,0,1,5,5,2,1,1,0,1,0
"kaggle:titanic","findRestart",36,8,7,3,5,4,1,2,0,1,3,1,0,0,0,0,0,0
"kaggle:titanic","matrix",13,11,11,2,9,8,1,1,0,1,8,1,6,2,4,1,1,0
"kaggle:titanic","getClassDef",60,42,40,1,41,37,1,0,0,4,31,10,12,0,12,0,0,0
"kaggle:titanic","getClass",16,8,8,1,7,6,1,0,0,1,4,3,3,0,3,0,0,0
"kaggle:titanic","FUN",4,3,3,0,3,3,0,0,0,0,2,1,0,0,0,0,0,0
"kaggle:titanic","FUN",4,3,3,0,3,3,0,0,0,0,2,1,0,0,0,0,0,0
"kaggle:titanic","FUN",4,3,3,0,3,3,0,0,0,0,2,1,0,0,0,0,0,0
"kaggle:titanic","FUN",4,3,3,0,3,3,0,0,0,0,2,1,2,0,2,0,0,0
"kaggle:titanic","FUN",4,3,3,0,3,3,0,0,0,0,2,1,2,0,2,0,0,0
"kaggle:titanic","FUN",4,3,3,0,3,3,0,0,0,0,2,1,0,0,0,0,0,0
"kaggle:titanic","FUN",4,3,3,0,3,3,0,0,0,0,2,1,0,0,0,0,0,0
"kaggle:titanic","FUN",4,3,3,0,3,3,0,0,0,0,2,1,0,0,0,0,0,0
"kaggle:titanic","FUN",4,3,3,0,3,3,0,0,0,0,2,1,0,0,0,0,0,0
"kaggle:titanic","FUN",4,3,3,0,3,3,0,0,0,0,2,1,0,0,0,0,0,0
"kaggle:titanic","ncol",4,3,3,0,3,3,0,0,0,0,2,1,3,0,3,0,0,0
"kaggle:titanic","unlist",27,24,24,0,24,24,0,0,0,0,21,3,2,0,2,0,0,0
"kaggle:titanic","Sys.getenv",59,19,19,8,11,7,5,3,0,4,10,0,3,2,1,1,1,0
"kaggle:titanic","unknown--fromConstant",5,4,4,0,4,3,0,0,0,1,2,2,1,0,1,0,0,0
"kaggle:titanic","asMethod",2,2,2,0,2,2,0,0,0,0,0,2,0,0,0,0,0,0
"kaggle:titanic","asMethod",16,10,10,1,9,8,1,0,0,1,3,5,0,0,0,0,0,0
"kaggle:titanic","backticks",3,3,2,0,3,2,0,0,0,1,2,0,0,0,0,0,0,0
"kaggle:titanic","formula",1,0,0,0,0,0,0,0,0,0,0,0,0,0,0,0,0,0
"kaggle:titanic","terms",1,0,0,0,0,0,0,0,0,0,0,0,0,0,0,0,0,0
"kaggle:titanic","FUN",363,42,40,10,32,23,6,4,0,9,25,3,7,0,7,0,0,0
"kaggle:titanic","rev",1,0,0,0,0,0,0,0,0,0,0,0,0,0,0,0,0,0
"kaggle:titanic","isSymmetric.matrix",93,55,55,11,44,36,10,1,0,8,42,2,0,0,0,0,0,0
"kaggle:titanic","eigen",155,84,82,17,67,51,12,5,0,16,54,9,19,3,16,0,3,0
"kaggle:titanic","unname",17,15,15,2,13,11,2,0,0,2,6,5,9,0,9,0,0,0
"kaggle:titanic","parent.frame",1,1,1,1,0,0,0,1,0,0,0,0,1,1,0,0,1,0
"kaggle:titanic","parent.frame",1,1,1,1,0,0,0,1,0,0,0,0,1,1,0,0,1,0
"kaggle:titanic","get",6,6,6,1,5,5,0,1,0,0,2,3,4,1,3,0,1,0
"kaggle:titanic","ma_exists",38,29,29,4,25,19,4,0,0,6,25,0,0,0,0,0,0,0
"kaggle:titanic","anyDuplicated",1,0,0,0,0,0,0,0,0,0,0,0,0,0,0,0,0,0
"kaggle:titanic","data.row.names",11,4,4,1,3,3,1,0,0,0,2,1,2,0,2,0,0,0
"kaggle:titanic","Matrix",190,50,50,20,30,23,19,1,0,7,24,4,2,0,2,0,0,0
"kaggle:titanic","isSymmetric",1,1,1,1,0,0,1,0,0,0,0,0,0,0,0,0,0,0
"kaggle:titanic","isTriangular",1,1,1,1,0,0,1,0,0,0,0,0,0,0,0,0,0,0
"kaggle:titanic","rangerCpp",107,54,54,0,54,54,0,0,0,0,48,6,0,0,0,0,0,0
"kaggle:titanic","runif",9,5,5,1,4,4,1,0,0,0,2,2,0,0,0,0,0,0
"kaggle:titanic","FUN",4,3,3,0,3,3,0,0,0,0,2,1,0,0,0,0,0,0
"kaggle:titanic","FUN",4,3,3,0,3,3,0,0,0,0,2,1,0,0,0,0,0,0
"kaggle:titanic","FUN",4,3,3,0,3,3,0,0,0,0,2,1,0,0,0,0,0,0
"kaggle:titanic","FUN",4,3,3,0,3,3,0,0,0,0,2,1,0,0,0,0,0,0
"kaggle:titanic","FUN",4,3,3,0,3,3,0,0,0,0,2,1,0,0,0,0,0,0
"kaggle:titanic","FUN",4,3,3,0,3,3,0,0,0,0,2,1,0,0,0,0,0,0
"kaggle:titanic","FUN",4,3,3,0,3,3,0,0,0,0,2,1,0,0,0,0,0,0
"kaggle:titanic","FUN",4,3,3,0,3,3,0,0,0,0,2,1,2,0,2,0,0,0
"kaggle:titanic","FUN",4,3,3,0,3,3,0,0,0,0,2,1,0,0,0,0,0,0
"kaggle:titanic","FUN",4,3,3,0,3,3,0,0,0,0,2,1,0,0,0,0,0,0
"kaggle:titanic","apply",375,156,152,63,93,70,41,22,0,23,84,5,58,23,35,3,20,0
"kaggle:titanic","levels",1,0,0,0,0,0,0,0,0,0,0,0,0,0,0,0,0,0
"kaggle:titanic","get",6,6,6,1,5,5,0,1,0,0,2,3,4,1,3,0,1,0
"kaggle:titanic","FUN",20,11,11,3,8,5,3,0,0,3,2,3,3,0,3,0,0,0
"kaggle:titanic","Make.row.names",48,21,21,6,15,9,5,1,0,6,13,2,2,0,2,0,0,0
"kaggle:titanic","var",41,30,28,6,24,14,6,0,0,10,15,5,6,0,6,0,0,0
"kaggle:titanic","unlist",27,24,24,1,23,23,0,1,0,0,20,3,2,1,1,0,1,0
"kaggle:titanic","FUN",4,3,3,0,3,3,0,0,0,0,2,1,0,0,0,0,0,0
"kaggle:titanic","FUN",4,3,3,0,3,3,0,0,0,0,2,1,2,0,2,0,0,0
"kaggle:titanic","FUN",4,3,3,0,3,3,0,0,0,0,2,1,0,0,0,0,0,0
"kaggle:titanic","FUN",4,3,3,0,3,3,0,0,0,0,2,1,0,0,0,0,0,0
"kaggle:titanic","FUN",4,3,3,0,3,3,0,0,0,0,2,1,0,0,0,0,0,0
"kaggle:titanic","FUN",4,3,3,0,3,3,0,0,0,0,2,1,0,0,0,0,0,0
"kaggle:titanic","FUN",4,3,3,0,3,3,0,0,0,0,2,1,0,0,0,0,0,0
"kaggle:titanic","FUN",4,3,3,0,3,3,0,0,0,0,2,1,0,0,0,0,0,0
"kaggle:titanic","FUN",4,3,3,0,3,3,0,0,0,0,2,1,0,0,0,0,0,0
"kaggle:titanic","FUN",4,3,3,0,3,3,0,0,0,0,2,1,0,0,0,0,0,0
"kaggle:titanic","t",1,0,0,0,0,0,0,0,0,0,0,0,0,0,0,0,0,0
"kaggle:titanic","as.matrix",1,0,0,0,0,0,0,0,0,0,0,0,0,0,0,0,0,0
"kaggle:titanic","data.matrix",151,9,9,2,7,5,2,0,0,2,3,2,3,0,3,0,0,0
"kaggle:titanic","FUN",4,3,3,0,3,3,0,0,0,0,2,1,0,0,0,0,0,0
"kaggle:titanic","FUN",4,3,3,0,3,3,0,0,0,0,2,1,0,0,0,0,0,0
"kaggle:titanic","FUN",4,3,3,0,3,3,0,0,0,0,2,1,0,0,0,0,0,0
"kaggle:titanic","FUN",4,3,3,0,3,3,0,0,0,0,2,1,0,0,0,0,0,0
"kaggle:titanic","FUN",4,3,3,0,3,3,0,0,0,0,2,1,2,0,2,0,0,0
"kaggle:titanic","FUN",4,3,3,0,3,3,0,0,0,0,2,1,0,0,0,0,0,0
"kaggle:titanic","FUN",4,3,3,0,3,3,0,0,0,0,2,1,0,0,0,0,0,0
"kaggle:titanic","FUN",4,3,3,0,3,3,0,0,0,0,2,1,0,0,0,0,0,0
"kaggle:titanic","FUN",4,3,3,0,3,3,0,0,0,0,2,1,0,0,0,0,0,0
"kaggle:titanic","FUN",4,3,3,0,3,3,0,0,0,0,2,1,0,0,0,0,0,0
"kaggle:titanic","URapply",4,4,4,1,3,3,1,0,0,0,2,1,1,0,1,0,0,0
"kaggle:titanic","factor",93,55,55,15,40,37,10,5,0,3,34,5,20,3,17,1,2,0
"kaggle:titanic","array",53,14,13,3,11,5,0,3,0,6,10,1,6,1,5,0,1,0
"kaggle:titanic","NCOL",9,6,5,3,3,3,2,1,0,0,1,2,2,1,1,0,1,0
"kaggle:titanic","colnames",28,19,19,4,15,10,3,1,0,5,5,7,8,1,7,0,1,0
"kaggle:titanic","reformulate",33,20,17,4,16,13,2,2,0,3,10,3,2,0,2,0,0,0
"kaggle:titanic","terms",1,0,0,0,0,0,0,0,0,0,0,0,0,0,0,0,0,0
"kaggle:titanic","model.frame",1,0,0,0,0,0,0,0,0,0,0,0,0,0,0,0,0,0
"kaggle:titanic","update",1,0,0,0,0,0,0,0,0,0,0,0,0,0,0,0,0,0
"kaggle:titanic","model.matrix",1,0,0,0,0,0,0,0,0,0,0,0,0,0,0,0,0,0
"kaggle:titanic","sampler.univ",259,154,150,49,105,99,33,16,0,6,88,14,27,1,26,0,1,0
"kaggle:titanic","labels",1,0,0,0,0,0,0,0,0,0,0,0,0,0,0,0,0,0
"kaggle:titanic","paste",4,4,4,4,0,0,1,3,0,0,0,0,2,2,0,0,2,0
"kaggle:titanic","formula",1,0,0,0,0,0,0,0,0,0,0,0,0,0,0,0,0,0
"kaggle:titanic","fixFormulaObject",161,46,41,9,37,30,7,2,0,7,31,3,2,0,2,0,0,0
"kaggle:titanic","terms",1,0,0,0,0,0,0,0,0,0,0,0,0,0,0,0,0,0
"kaggle:titanic","%||%",3,2,2,2,0,0,0,2,0,0,0,0,0,0,0,0,0,0
"kaggle:titanic","paste",4,4,4,4,0,0,1,3,0,0,0,0,2,2,0,0,2,0
"kaggle:titanic","get",6,6,6,0,6,6,0,0,0,0,2,4,4,0,4,0,0,0
"kaggle:titanic","assign",6,6,6,0,6,6,0,0,0,0,3,3,1,0,1,0,0,0
"kaggle:titanic","var",41,30,28,6,24,14,6,0,0,10,15,5,6,0,6,0,0,0
"kaggle:titanic","isSymmetric.matrix",93,55,55,11,44,37,10,1,0,7,42,2,0,0,0,0,0,0
"kaggle:titanic","eigen",155,84,82,17,67,51,12,5,0,16,54,9,19,3,16,0,3,0
"kaggle:titanic","eigen",155,84,82,17,67,51,12,5,0,16,54,9,19,3,16,0,3,0
"kaggle:titanic","remove.lindep",235,127,126,31,96,91,27,4,0,5,89,7,9,2,7,0,2,0
"kaggle:titanic","updateLog",64,46,46,3,43,43,3,0,0,0,36,7,6,1,5,1,0,0
"kaggle:titanic","",1,0,0,0,0,0,0,0,0,0,0,0,0,0,0,0,0,0
"kaggle:titanic","unlist",27,24,24,1,23,23,0,1,0,0,20,3,2,1,1,0,1,0
"kaggle:titanic","unlist",27,24,24,1,23,23,0,1,0,0,20,3,2,1,1,0,1,0
"kaggle:titanic","structure",55,26,23,8,18,15,4,4,0,3,17,1,6,2,4,0,2,0
"kaggle:titanic","simplify2array",124,45,44,15,30,25,9,6,0,5,29,1,11,4,7,0,4,0
"kaggle:titanic","array",53,14,10,6,8,2,1,5,0,6,8,0,6,4,2,1,3,0
"kaggle:titanic","match.names",35,11,11,1,10,4,1,0,0,6,10,0,2,0,2,0,0,0
"kaggle:titanic","make.unique",2,2,2,1,1,1,0,1,0,0,0,1,0,0,0,0,0,0
"kaggle:titanic","tabulate",28,20,18,3,17,12,1,2,0,5,14,2,3,0,3,0,0,0
"kaggle:titanic","FUN",4,3,3,0,3,3,0,0,0,0,2,1,0,0,0,0,0,0
"kaggle:titanic","FUN",4,3,3,0,3,3,0,0,0,0,2,1,0,0,0,0,0,0
"kaggle:titanic","FUN",4,3,3,0,3,3,0,0,0,0,2,1,0,0,0,0,0,0
"kaggle:titanic","FUN",4,3,3,0,3,3,0,0,0,0,2,1,0,0,0,0,0,0
"kaggle:titanic","FUN",4,3,3,0,3,3,0,0,0,0,2,1,0,0,0,0,0,0
"kaggle:titanic","FUN",4,3,3,0,3,3,0,0,0,0,2,1,0,0,0,0,0,0
"kaggle:titanic","FUN",4,3,3,0,3,3,0,0,0,0,2,1,0,0,0,0,0,0
"kaggle:titanic","FUN",4,3,3,0,3,3,0,0,0,0,2,1,0,0,0,0,0,0
"kaggle:titanic","FUN",4,3,3,0,3,3,0,0,0,0,2,1,0,0,0,0,0,0
"kaggle:titanic","FUN",4,3,3,0,3,3,0,0,0,0,2,1,0,0,0,0,0,0
"kaggle:titanic","FUN",4,3,3,0,3,3,0,0,0,0,2,1,0,0,0,0,0,0
"kaggle:titanic","FUN",4,3,3,0,3,3,0,0,0,0,2,1,0,0,0,0,0,0
"kaggle:titanic","FUN",4,3,3,0,3,3,0,0,0,0,2,1,0,0,0,0,0,0
"kaggle:titanic","FUN",4,3,3,0,3,3,0,0,0,0,2,1,0,0,0,0,0,0
"kaggle:titanic","FUN",4,3,3,0,3,3,0,0,0,0,2,1,0,0,0,0,0,0
"kaggle:titanic","FUN",4,3,3,0,3,3,0,0,0,0,2,1,0,0,0,0,0,0
"kaggle:titanic","FUN",4,3,3,0,3,3,0,0,0,0,2,1,0,0,0,0,0,0
"kaggle:titanic","FUN",4,3,3,0,3,3,0,0,0,0,2,1,0,0,0,0,0,0
"kaggle:titanic","FUN",4,3,3,0,3,3,0,0,0,0,2,1,0,0,0,0,0,0
"kaggle:titanic","FUN",4,3,3,0,3,3,0,0,0,0,2,1,0,0,0,0,0,0
"kaggle:titanic","ncol",4,3,3,1,2,2,0,1,0,0,1,1,3,1,2,0,1,0
"kaggle:titanic","rangerCpp",107,54,54,0,54,54,0,0,0,0,48,6,0,0,0,0,0,0
"kaggle:titanic","FUN",4,3,3,0,3,3,0,0,0,0,2,1,0,0,0,0,0,0
"kaggle:titanic","FUN",4,3,3,0,3,3,0,0,0,0,2,1,0,0,0,0,0,0
"kaggle:titanic","FUN",4,3,3,0,3,3,0,0,0,0,2,1,0,0,0,0,0,0
"kaggle:titanic","FUN",4,3,3,0,3,3,0,0,0,0,2,1,0,0,0,0,0,0
"kaggle:titanic","FUN",4,3,3,0,3,3,0,0,0,0,2,1,0,0,0,0,0,0
"kaggle:titanic","FUN",4,3,3,0,3,3,0,0,0,0,2,1,0,0,0,0,0,0
"kaggle:titanic","FUN",4,3,3,0,3,3,0,0,0,0,2,1,0,0,0,0,0,0
"kaggle:titanic","FUN",4,3,3,0,3,3,0,0,0,0,2,1,0,0,0,0,0,0
"kaggle:titanic","FUN",4,3,3,0,3,3,0,0,0,0,2,1,0,0,0,0,0,0
"kaggle:titanic","FUN",4,3,3,0,3,3,0,0,0,0,2,1,0,0,0,0,0,0
"kaggle:titanic","droplevels",1,0,0,0,0,0,0,0,0,0,0,0,0,0,0,0,0,0
"kaggle:titanic","FUN",4,3,3,0,3,3,0,0,0,0,2,1,2,0,2,0,0,0
"kaggle:titanic","FUN",4,3,3,0,3,3,0,0,0,0,2,1,0,0,0,0,0,0
"kaggle:titanic","FUN",4,3,3,0,3,3,0,0,0,0,2,1,0,0,0,0,0,0
"kaggle:titanic","FUN",4,3,3,0,3,3,0,0,0,0,2,1,0,0,0,0,0,0
"kaggle:titanic","FUN",4,3,3,0,3,3,0,0,0,0,2,1,0,0,0,0,0,0
"kaggle:titanic","FUN",4,3,3,0,3,3,0,0,0,0,2,1,0,0,0,0,0,0
"kaggle:titanic","FUN",4,3,3,0,3,3,0,0,0,0,2,1,0,0,0,0,0,0
"kaggle:titanic","FUN",4,3,3,0,3,3,0,0,0,0,2,1,0,0,0,0,0,0
"kaggle:titanic","FUN",4,3,3,0,3,3,0,0,0,0,2,1,0,0,0,0,0,0
"kaggle:titanic","FUN",4,3,3,0,3,3,0,0,0,0,2,1,0,0,0,0,0,0
"kaggle:titanic","FUN",4,3,3,0,3,3,0,0,0,0,2,1,0,0,0,0,0,0
"kaggle:titanic","FUN",4,3,3,0,3,3,0,0,0,0,2,1,0,0,0,0,0,0
"kaggle:titanic","FUN",4,3,3,0,3,3,0,0,0,0,2,1,0,0,0,0,0,0
"kaggle:titanic","FUN",4,3,3,0,3,3,0,0,0,0,2,1,0,0,0,0,0,0
"kaggle:titanic","FUN",4,3,3,0,3,3,0,0,0,0,2,1,0,0,0,0,0,0
"kaggle:titanic","FUN",4,3,3,0,3,3,0,0,0,0,2,1,0,0,0,0,0,0
"kaggle:titanic","FUN",4,3,3,0,3,3,0,0,0,0,2,1,0,0,0,0,0,0
"kaggle:titanic","FUN",4,3,3,0,3,3,0,0,0,0,2,1,0,0,0,0,0,0
"kaggle:titanic","FUN",4,3,3,0,3,3,0,0,0,0,2,1,0,0,0,0,0,0
"kaggle:titanic","FUN",4,3,3,0,3,3,0,0,0,0,2,1,2,0,2,0,0,0
"kaggle:titanic","colMeans",95,45,44,20,25,20,16,4,0,5,19,4,9,2,7,0,2,0
"kaggle:titanic","paste",4,4,4,4,0,0,1,3,0,0,0,0,2,2,0,0,2,0
"kaggle:titanic","formula",1,0,0,0,0,0,0,0,0,0,0,0,0,0,0,0,0,0
"kaggle:titanic","fixFormulaObject",157,42,40,9,33,29,7,2,0,4,31,2,0,0,0,0,0,0
"kaggle:titanic","FUN",4,3,3,0,3,3,0,0,0,0,2,1,0,0,0,0,0,0
"kaggle:titanic","FUN",4,3,3,0,3,3,0,0,0,0,2,1,2,0,2,0,0,0
"kaggle:titanic","FUN",4,3,3,0,3,3,0,0,0,0,2,1,0,0,0,0,0,0
"kaggle:titanic","FUN",4,3,3,0,3,3,0,0,0,0,2,1,0,0,0,0,0,0
"kaggle:titanic","FUN",4,3,3,0,3,3,0,0,0,0,2,1,0,0,0,0,0,0
"kaggle:titanic","FUN",4,3,3,0,3,3,0,0,0,0,2,1,0,0,0,0,0,0
"kaggle:titanic","FUN",4,3,3,0,3,3,0,0,0,0,2,1,0,0,0,0,0,0
"kaggle:titanic","FUN",4,3,3,0,3,3,0,0,0,0,2,1,0,0,0,0,0,0
"kaggle:titanic","FUN",4,3,3,0,3,3,0,0,0,0,2,1,0,0,0,0,0,0
"kaggle:titanic","FUN",4,3,3,0,3,3,0,0,0,0,2,1,0,0,0,0,0,0
"kaggle:titanic","FUN",4,3,3,0,3,3,0,0,0,0,2,1,0,0,0,0,0,0
"kaggle:titanic","FUN",4,3,3,0,3,3,0,0,0,0,2,1,0,0,0,0,0,0
"kaggle:titanic","FUN",4,3,3,0,3,3,0,0,0,0,2,1,0,0,0,0,0,0
"kaggle:titanic","FUN",4,3,3,0,3,3,0,0,0,0,2,1,0,0,0,0,0,0
"kaggle:titanic","FUN",4,3,3,0,3,3,0,0,0,0,2,1,0,0,0,0,0,0
"kaggle:titanic","FUN",4,3,3,0,3,3,0,0,0,0,2,1,0,0,0,0,0,0
"kaggle:titanic","FUN",4,3,3,0,3,3,0,0,0,0,2,1,0,0,0,0,0,0
"kaggle:titanic","FUN",4,3,3,0,3,3,0,0,0,0,2,1,0,0,0,0,0,0
"kaggle:titanic","FUN",4,3,3,0,3,3,0,0,0,0,2,1,0,0,0,0,0,0
"kaggle:titanic","FUN",4,3,3,0,3,3,0,0,0,0,2,1,0,0,0,0,0,0
"kaggle:titanic","factor",93,55,55,15,40,37,10,5,0,3,34,5,20,3,17,1,2,0
"kaggle:titanic","FUN",4,3,3,0,3,3,0,0,0,0,2,1,0,0,0,0,0,0
"kaggle:titanic","FUN",4,3,3,0,3,3,0,0,0,0,2,1,0,0,0,0,0,0
"kaggle:titanic","FUN",4,3,3,0,3,3,0,0,0,0,2,1,0,0,0,0,0,0
"kaggle:titanic","FUN",4,3,3,0,3,3,0,0,0,0,2,1,0,0,0,0,0,0
"kaggle:titanic","FUN",4,3,3,0,3,3,0,0,0,0,2,1,0,0,0,0,0,0
"kaggle:titanic","FUN",4,3,3,0,3,3,0,0,0,0,2,1,0,0,0,0,0,0
"kaggle:titanic","FUN",4,3,3,0,3,3,0,0,0,0,2,1,0,0,0,0,0,0
"kaggle:titanic","FUN",4,3,3,0,3,3,0,0,0,0,2,1,0,0,0,0,0,0
"kaggle:titanic","FUN",4,3,3,0,3,3,0,0,0,0,2,1,0,0,0,0,0,0
"kaggle:titanic","FUN",4,3,3,0,3,3,0,0,0,0,2,1,2,0,2,0,0,0
"kaggle:titanic","FUN",4,3,3,0,3,3,0,0,0,0,2,1,2,0,2,0,0,0
"kaggle:titanic","FUN",4,3,3,0,3,3,0,0,0,0,2,1,0,0,0,0,0,0
"kaggle:titanic","FUN",4,3,3,0,3,3,0,0,0,0,2,1,0,0,0,0,0,0
"kaggle:titanic","FUN",4,3,3,0,3,3,0,0,0,0,2,1,0,0,0,0,0,0
"kaggle:titanic","FUN",4,3,3,0,3,3,0,0,0,0,2,1,0,0,0,0,0,0
"kaggle:titanic","FUN",4,3,3,0,3,3,0,0,0,0,2,1,0,0,0,0,0,0
"kaggle:titanic","FUN",4,3,3,0,3,3,0,0,0,0,2,1,0,0,0,0,0,0
"kaggle:titanic","FUN",4,3,3,0,3,3,0,0,0,0,2,1,0,0,0,0,0,0
"kaggle:titanic","FUN",4,3,3,0,3,3,0,0,0,0,2,1,0,0,0,0,0,0
"kaggle:titanic","FUN",4,3,3,0,3,3,0,0,0,0,2,1,0,0,0,0,0,0
"kaggle:titanic","remove.lindep",235,127,126,31,96,91,27,4,0,5,89,7,9,2,7,0,2,0
"kaggle:titanic","FUN",4,3,3,0,3,3,0,0,0,0,2,1,0,0,0,0,0,0
"kaggle:titanic","FUN",4,3,3,0,3,3,0,0,0,0,2,1,0,0,0,0,0,0
"kaggle:titanic","FUN",4,3,3,0,3,3,0,0,0,0,2,1,2,0,2,0,0,0
"kaggle:titanic","FUN",4,3,3,0,3,3,0,0,0,0,2,1,0,0,0,0,0,0
"kaggle:titanic","FUN",4,3,3,0,3,3,0,0,0,0,2,1,0,0,0,0,0,0
"kaggle:titanic","FUN",4,3,3,0,3,3,0,0,0,0,2,1,0,0,0,0,0,0
"kaggle:titanic","FUN",4,3,3,0,3,3,0,0,0,0,2,1,2,0,2,0,0,0
"kaggle:titanic","FUN",4,3,3,0,3,3,0,0,0,0,2,1,0,0,0,0,0,0
"kaggle:titanic","FUN",4,3,3,0,3,3,0,0,0,0,2,1,0,0,0,0,0,0
"kaggle:titanic","FUN",4,3,3,0,3,3,0,0,0,0,2,1,0,0,0,0,0,0
"kaggle:titanic","FUN",4,3,3,0,3,3,0,0,0,0,2,1,0,0,0,0,0,0
"kaggle:titanic","FUN",4,3,3,0,3,3,0,0,0,0,2,1,0,0,0,0,0,0
"kaggle:titanic","FUN",4,3,3,0,3,3,0,0,0,0,2,1,0,0,0,0,0,0
"kaggle:titanic","FUN",4,3,3,0,3,3,0,0,0,0,2,1,0,0,0,0,0,0
"kaggle:titanic","FUN",4,3,3,0,3,3,0,0,0,0,2,1,0,0,0,0,0,0
"kaggle:titanic","FUN",4,3,3,0,3,3,0,0,0,0,2,1,0,0,0,0,0,0
"kaggle:titanic","FUN",4,3,3,0,3,3,0,0,0,0,2,1,0,0,0,0,0,0
"kaggle:titanic","FUN",4,3,3,0,3,3,0,0,0,0,2,1,0,0,0,0,0,0
"kaggle:titanic","FUN",4,3,3,0,3,3,0,0,0,0,2,1,0,0,0,0,0,0
"kaggle:titanic","FUN",4,3,3,0,3,3,0,0,0,0,2,1,0,0,0,0,0,0
"kaggle:titanic","FUN",4,3,3,0,3,3,0,0,0,0,2,1,0,0,0,0,0,0
"kaggle:titanic","FUN",4,3,3,0,3,3,0,0,0,0,2,1,0,0,0,0,0,0
"kaggle:titanic","FUN",4,3,3,0,3,3,0,0,0,0,2,1,0,0,0,0,0,0
"kaggle:titanic","FUN",4,3,3,0,3,3,0,0,0,0,2,1,0,0,0,0,0,0
"kaggle:titanic","FUN",4,3,3,0,3,3,0,0,0,0,2,1,0,0,0,0,0,0
"kaggle:titanic","FUN",4,3,3,0,3,3,0,0,0,0,2,1,0,0,0,0,0,0
"kaggle:titanic","FUN",4,3,3,0,3,3,0,0,0,0,2,1,0,0,0,0,0,0
"kaggle:titanic","FUN",4,3,3,0,3,3,0,0,0,0,2,1,0,0,0,0,0,0
"kaggle:titanic","FUN",4,3,3,0,3,3,0,0,0,0,2,1,0,0,0,0,0,0
"kaggle:titanic","FUN",4,3,3,0,3,3,0,0,0,0,2,1,0,0,0,0,0,0
"kaggle:titanic","FUN",4,3,3,0,3,3,0,0,0,0,2,1,0,0,0,0,0,0
"kaggle:titanic","FUN",4,3,3,0,3,3,0,0,0,0,2,1,0,0,0,0,0,0
"kaggle:titanic","FUN",4,3,3,0,3,3,0,0,0,0,2,1,0,0,0,0,0,0
"kaggle:titanic","FUN",4,3,3,0,3,3,0,0,0,0,2,1,0,0,0,0,0,0
"kaggle:titanic","FUN",4,3,3,0,3,3,0,0,0,0,2,1,0,0,0,0,0,0
"kaggle:titanic","FUN",4,3,3,0,3,3,0,0,0,0,2,1,0,0,0,0,0,0
"kaggle:titanic","FUN",4,3,3,0,3,3,0,0,0,0,2,1,0,0,0,0,0,0
"kaggle:titanic","FUN",4,3,3,0,3,3,0,0,0,0,2,1,0,0,0,0,0,0
"kaggle:titanic","FUN",4,3,3,0,3,3,0,0,0,0,2,1,0,0,0,0,0,0
"kaggle:titanic","FUN",4,3,3,0,3,3,0,0,0,0,2,1,0,0,0,0,0,0
"kaggle:titanic","FUN",4,3,3,0,3,3,0,0,0,0,2,1,0,0,0,0,0,0
"kaggle:titanic","FUN",4,3,3,0,3,3,0,0,0,0,2,1,0,0,0,0,0,0
"kaggle:titanic","FUN",4,3,3,0,3,3,0,0,0,0,2,1,0,0,0,0,0,0
"kaggle:titanic","FUN",4,3,3,0,3,3,0,0,0,0,2,1,0,0,0,0,0,0
"kaggle:titanic","FUN",4,3,3,0,3,3,0,0,0,0,2,1,2,0,2,0,0,0
"kaggle:titanic","FUN",4,3,3,0,3,3,0,0,0,0,2,1,0,0,0,0,0,0
"kaggle:titanic","FUN",4,3,3,0,3,3,0,0,0,0,2,1,0,0,0,0,0,0
"kaggle:titanic","FUN",4,3,3,0,3,3,0,0,0,0,2,1,0,0,0,0,0,0
"kaggle:titanic","FUN",4,3,3,0,3,3,0,0,0,0,2,1,0,0,0,0,0,0
"kaggle:titanic","FUN",4,3,3,0,3,3,0,0,0,0,2,1,0,0,0,0,0,0
"kaggle:titanic","FUN",4,3,3,0,3,3,0,0,0,0,2,1,0,0,0,0,0,0
"kaggle:titanic","FUN",4,3,3,0,3,3,0,0,0,0,2,1,0,0,0,0,0,0
"kaggle:titanic","FUN",4,3,3,0,3,3,0,0,0,0,2,1,0,0,0,0,0,0
"kaggle:titanic","FUN",4,3,3,0,3,3,0,0,0,0,2,1,0,0,0,0,0,0
"kaggle:titanic","FUN",4,3,3,0,3,3,0,0,0,0,2,1,0,0,0,0,0,0
"kaggle:titanic","FUN",4,3,3,0,3,3,0,0,0,0,2,1,0,0,0,0,0,0
"kaggle:titanic","FUN",4,3,3,0,3,3,0,0,0,0,2,1,0,0,0,0,0,0
"kaggle:titanic","FUN",4,3,3,0,3,3,0,0,0,0,2,1,0,0,0,0,0,0
"kaggle:titanic","FUN",4,3,3,0,3,3,0,0,0,0,2,1,0,0,0,0,0,0
"kaggle:titanic","FUN",4,3,3,0,3,3,0,0,0,0,2,1,0,0,0,0,0,0
"kaggle:titanic","FUN",4,3,3,0,3,3,0,0,0,0,2,1,0,0,0,0,0,0
"kaggle:titanic","FUN",4,3,3,0,3,3,0,0,0,0,2,1,0,0,0,0,0,0
"kaggle:titanic","FUN",4,3,3,0,3,3,0,0,0,0,2,1,0,0,0,0,0,0
"kaggle:titanic","FUN",4,3,3,0,3,3,0,0,0,0,2,1,0,0,0,0,0,0
"kaggle:titanic","FUN",4,3,3,0,3,3,0,0,0,0,2,1,0,0,0,0,0,0
"kaggle:titanic","FUN",4,3,3,0,3,3,0,0,0,0,2,1,0,0,0,0,0,0
"kaggle:titanic","FUN",4,3,3,0,3,3,0,0,0,0,2,1,0,0,0,0,0,0
"kaggle:titanic","FUN",4,3,3,0,3,3,0,0,0,0,2,1,0,0,0,0,0,0
"kaggle:titanic","FUN",4,3,3,0,3,3,0,0,0,0,2,1,0,0,0,0,0,0
"kaggle:titanic","FUN",4,3,3,0,3,3,0,0,0,0,2,1,0,0,0,0,0,0
"kaggle:titanic","FUN",4,3,3,0,3,3,0,0,0,0,2,1,0,0,0,0,0,0
"kaggle:titanic","FUN",4,3,3,0,3,3,0,0,0,0,2,1,0,0,0,0,0,0
"kaggle:titanic","FUN",4,3,3,0,3,3,0,0,0,0,2,1,0,0,0,0,0,0
"kaggle:titanic","FUN",4,3,3,0,3,3,0,0,0,0,2,1,0,0,0,0,0,0
"kaggle:titanic","FUN",4,3,3,0,3,3,0,0,0,0,2,1,0,0,0,0,0,0
"kaggle:titanic","FUN",4,3,3,0,3,3,0,0,0,0,2,1,0,0,0,0,0,0
"kaggle:titanic","FUN",4,3,3,0,3,3,0,0,0,0,2,1,0,0,0,0,0,0
"kaggle:titanic","FUN",4,3,3,0,3,3,0,0,0,0,2,1,2,0,2,0,0,0
"kaggle:titanic","FUN",4,3,3,0,3,3,0,0,0,0,2,1,0,0,0,0,0,0
"kaggle:titanic","FUN",4,3,3,0,3,3,0,0,0,0,2,1,0,0,0,0,0,0
"kaggle:titanic","FUN",4,3,3,0,3,3,0,0,0,0,2,1,0,0,0,0,0,0
"kaggle:titanic","FUN",4,3,3,0,3,3,0,0,0,0,2,1,0,0,0,0,0,0
"kaggle:titanic","FUN",4,3,3,0,3,3,0,0,0,0,2,1,0,0,0,0,0,0
"kaggle:titanic","FUN",4,3,3,0,3,3,0,0,0,0,2,1,0,0,0,0,0,0
"kaggle:titanic","FUN",4,3,3,0,3,3,0,0,0,0,2,1,0,0,0,0,0,0
"kaggle:titanic","FUN",4,3,3,0,3,3,0,0,0,0,2,1,0,0,0,0,0,0
"kaggle:titanic","FUN",4,3,3,0,3,3,0,0,0,0,2,1,0,0,0,0,0,0
"kaggle:titanic","FUN",4,3,3,0,3,3,0,0,0,0,2,1,0,0,0,0,0,0
"kaggle:titanic","FUN",4,3,3,0,3,3,0,0,0,0,2,1,0,0,0,0,0,0
"kaggle:titanic","FUN",4,3,3,0,3,3,0,0,0,0,2,1,0,0,0,0,0,0
"kaggle:titanic","FUN",4,3,3,0,3,3,0,0,0,0,2,1,0,0,0,0,0,0
"kaggle:titanic","FUN",4,3,3,0,3,3,0,0,0,0,2,1,0,0,0,0,0,0
"kaggle:titanic","FUN",4,3,3,0,3,3,0,0,0,0,2,1,0,0,0,0,0,0
"kaggle:titanic","FUN",4,3,3,0,3,3,0,0,0,0,2,1,0,0,0,0,0,0
"kaggle:titanic","FUN",4,3,3,0,3,3,0,0,0,0,2,1,0,0,0,0,0,0
"kaggle:titanic","FUN",4,3,3,0,3,3,0,0,0,0,2,1,0,0,0,0,0,0
"kaggle:titanic","FUN",4,3,3,0,3,3,0,0,0,0,2,1,2,0,2,0,0,0
"kaggle:titanic","FUN",4,3,3,0,3,3,0,0,0,0,2,1,0,0,0,0,0,0
"kaggle:titanic","FUN",4,3,3,0,3,3,0,0,0,0,2,1,0,0,0,0,0,0
"kaggle:titanic","FUN",4,3,3,0,3,3,0,0,0,0,2,1,0,0,0,0,0,0
"kaggle:titanic","FUN",4,3,3,0,3,3,0,0,0,0,2,1,0,0,0,0,0,0
"kaggle:titanic","FUN",4,3,3,0,3,3,0,0,0,0,2,1,0,0,0,0,0,0
"kaggle:titanic","FUN",4,3,3,0,3,3,0,0,0,0,2,1,0,0,0,0,0,0
"kaggle:titanic","FUN",4,3,3,0,3,3,0,0,0,0,2,1,0,0,0,0,0,0
"kaggle:titanic","FUN",4,3,3,0,3,3,0,0,0,0,2,1,0,0,0,0,0,0
"kaggle:titanic","FUN",4,3,3,0,3,3,0,0,0,0,2,1,0,0,0,0,0,0
"kaggle:titanic","FUN",4,3,3,0,3,3,0,0,0,0,2,1,0,0,0,0,0,0
"kaggle:titanic","FUN",4,3,3,0,3,3,0,0,0,0,2,1,0,0,0,0,0,0
"kaggle:titanic","FUN",4,3,3,0,3,3,0,0,0,0,2,1,0,0,0,0,0,0
"kaggle:titanic","FUN",4,3,3,0,3,3,0,0,0,0,2,1,0,0,0,0,0,0
"kaggle:titanic","inject",10,5,4,0,5,3,0,0,0,2,2,2,1,0,1,0,0,0
"kaggle:titanic","deparse",11,11,7,2,9,5,1,1,0,4,8,0,2,1,1,0,1,0
"kaggle:titanic","is_call",11,6,6,1,5,5,1,0,0,0,2,3,4,0,4,0,0,0
"kaggle:titanic","strip_dots",102,55,55,12,43,40,7,5,0,3,33,8,16,2,14,0,2,0
"kaggle:titanic","make_labels",9,9,9,0,9,9,0,0,0,0,5,4,7,0,7,0,0,0
"kaggle:titanic","sym_text",83,60,59,17,43,36,12,5,0,7,28,12,15,4,11,1,3,0
"kaggle:titanic","strip_stage",43,21,21,4,17,17,3,1,0,0,10,7,11,0,11,0,0,0
"kaggle:titanic","quo_get_env",5,3,3,0,3,3,0,0,0,0,0,3,0,0,0,0,0,0
"kaggle:titanic","caller_env",3,3,3,0,3,3,0,0,0,0,2,1,0,0,0,0,0,0
"kaggle:titanic","chartr",9,5,5,1,4,4,0,1,0,0,3,1,0,0,0,0,0,0
"kaggle:titanic","is_call",11,6,6,1,5,5,1,0,0,0,2,3,4,0,4,0,0,0
"kaggle:titanic","strip_dots",102,55,55,12,43,40,7,5,0,3,33,8,16,2,14,0,2,0
"kaggle:titanic","",49,42,42,3,39,34,3,0,0,5,19,17,15,0,15,0,0,0
"kaggle:titanic","sym_text",83,60,59,17,43,36,12,5,0,7,28,12,15,4,11,1,3,0
"kaggle:titanic","expr_text",45,21,16,4,17,12,2,2,0,5,9,5,3,1,2,0,1,0
"kaggle:titanic","element_line",87,54,52,11,43,33,7,4,0,10,35,8,13,2,11,0,2,0
"kaggle:titanic","plot_clone",11,2,2,0,2,2,0,0,0,0,2,0,0,0,0,0,0,0
"kaggle:titanic","unknown--fromConstant",12,7,7,0,7,7,0,0,0,0,4,3,2,0,2,0,0,0
"kaggle:titanic","data_frame0",1,1,1,0,1,1,0,0,0,0,0,1,0,0,0,0,0,0
"kaggle:titanic","vec_size",7,4,4,1,3,3,1,0,0,0,0,3,1,0,1,0,0,0
"kaggle:titanic","set_names",13,7,7,1,6,6,0,1,0,0,3,3,3,1,2,0,1,0
"kaggle:titanic","vec_unique",4,4,4,0,4,4,0,0,0,0,3,1,3,0,3,0,0,0
"kaggle:titanic","vec_unique_loc",5,3,3,0,3,3,0,0,0,0,0,3,1,0,1,0,0,0
"kaggle:titanic","is_character",7,4,4,1,3,3,1,0,0,0,0,3,2,0,2,0,0,0
"kaggle:titanic","stdin",0,0,0,0,0,0,0,0,0,0,0,0,0,0,0,0,0,0
"kaggle:titanic","FUN",41,18,18,4,14,14,3,1,0,0,5,9,10,1,9,0,1,0
"kaggle:titanic","is_bare_list",13,9,9,2,7,6,2,0,0,1,5,2,1,0,1,0,0,0
"kaggle:titanic","scale_apply",50,35,33,8,27,24,5,3,0,3,17,10,6,2,4,0,2,0
"kaggle:titanic","FUN",91,71,71,14,57,53,6,8,0,4,52,5,4,0,4,0,0,0
"kaggle:titanic","add_handler",148,74,68,12,62,47,10,2,0,15,52,8,7,1,6,1,0,0
"kaggle:titanic","defer",21,10,10,0,10,9,0,0,0,1,8,2,0,0,0,0,0,0
"kaggle:titanic","frame_loc",47,33,33,6,27,26,5,1,0,1,26,1,2,0,2,0,0,0
"kaggle:titanic","cli__message",91,49,49,11,38,31,5,6,0,7,31,7,9,1,8,1,0,0
"kaggle:titanic","setup_handlers",44,23,23,2,21,15,2,0,0,6,15,6,2,0,2,0,0,0
"kaggle:titanic","trim",17,9,9,4,5,5,4,0,0,0,4,1,0,0,0,0,0,0
"kaggle:titanic","",28,12,12,3,9,7,2,1,0,2,4,3,2,0,2,0,0,0
"kaggle:titanic","substring",38,23,20,12,11,9,4,8,0,2,9,2,11,8,3,0,8,0
"kaggle:titanic","regexpr",57,11,11,2,9,9,1,1,0,0,9,0,0,0,0,0,0,0
"kaggle:titanic","glue",75,47,45,15,32,27,9,6,0,5,24,6,15,5,10,2,3,0
"kaggle:titanic",".transformer",111,77,75,17,60,50,10,7,0,10,52,6,13,4,9,1,3,0
"kaggle:titanic","%??%",8,5,5,0,5,5,0,0,0,0,2,3,2,0,2,0,0,0
"kaggle:titanic","process_plural",99,32,32,11,21,21,6,5,0,0,18,3,5,2,3,0,2,0
"kaggle:titanic","chain_error",15,12,12,1,11,9,0,1,0,2,9,1,3,0,3,0,0,0
"kaggle:titanic","parse_plural",38,17,17,3,14,11,2,1,0,3,12,2,0,0,0,0,0,0
"kaggle:titanic","inline_regex",0,0,0,0,0,0,0,0,0,0,0,0,0,0,0,0,0,0
"kaggle:titanic","cli__message_create",20,8,8,1,7,7,1,0,0,0,5,2,0,0,0,0,0,0
"kaggle:titanic","get_handlers",3,2,2,0,2,2,0,0,0,0,0,2,2,0,2,0,0,0
"kaggle:titanic","make_ansi_style",96,62,62,13,49,40,5,8,0,9,45,2,13,0,13,0,0,0
"kaggle:titanic","create_ansi_style",94,61,59,9,52,47,4,5,0,5,46,6,15,2,13,0,2,0
"kaggle:titanic","ansi_style_from_r_color",25,19,19,4,15,15,1,3,0,0,10,5,1,1,0,0,1,0
"kaggle:titanic","ansi256",109,38,38,14,24,23,8,6,0,1,19,5,0,0,0,0,0,0
"kaggle:titanic","merge_embedded_styles",112,66,63,16,50,45,12,4,0,5,47,1,28,1,27,0,1,0
"kaggle:titanic","clii__container_start",287,134,132,23,111,100,19,4,0,11,98,13,34,3,31,0,3,0
"kaggle:titanic","glue",75,47,45,14,33,29,9,5,0,4,25,6,15,5,10,2,3,0
"kaggle:titanic","sub",40,15,15,4,11,11,1,3,0,0,11,0,2,0,2,0,0,0
"kaggle:titanic","trimws",22,14,14,1,13,12,0,1,0,1,13,0,0,0,0,0,0,0
"kaggle:titanic","ansi_string",16,5,5,1,4,4,0,1,0,0,2,2,0,0,0,0,0,0
"kaggle:titanic","ansi_strip",33,17,17,1,16,16,0,1,0,0,15,1,0,0,0,0,0,0
"kaggle:titanic","peek_option",7,6,6,0,6,5,0,0,0,1,2,4,2,0,2,0,0,0
"kaggle:titanic","is_string",7,4,4,1,3,3,1,0,0,0,0,3,2,0,2,0,0,0
"kaggle:titanic","sort",8,5,4,2,3,0,2,0,0,3,2,0,0,0,0,0,0,0
"kaggle:titanic","id_var",35,19,19,5,14,12,5,0,0,2,12,2,8,0,8,0,0,0
"kaggle:titanic","formatC",259,124,120,36,88,77,22,14,0,11,85,1,5,1,4,1,0,0
"kaggle:titanic","storage.mode",4,4,4,1,3,1,1,0,0,2,2,0,1,0,1,0,0,0
"kaggle:titanic","expand_range4",64,47,47,16,31,30,15,1,0,1,29,2,4,1,3,1,0,0
"kaggle:titanic","expand_range4",64,47,47,16,31,30,15,1,0,1,29,2,4,1,3,1,0,0
"kaggle:titanic","expand_limits_continuous_trans",46,30,30,7,23,19,7,0,0,4,21,1,1,0,1,0,0,0
"kaggle:titanic","expansion",42,27,27,6,21,19,6,0,0,2,20,1,4,1,3,1,0,0
"kaggle:titanic","with_ordered_restart",2,2,2,0,2,2,0,0,0,0,2,0,0,0,0,0,0,0
"kaggle:titanic","",1,1,1,0,1,1,0,0,0,0,0,1,0,0,0,0,0,0
"kaggle:titanic","new.env",4,4,3,3,1,0,1,2,0,1,0,0,2,2,0,0,2,0
"kaggle:titanic","startsWith",2,2,2,1,1,1,0,1,0,0,0,1,0,0,0,0,0,0
"kaggle:titanic","has_flipped_aes",196,88,87,21,67,56,20,1,0,11,59,5,12,0,12,0,0,0
"kaggle:titanic","xor",17,7,5,5,2,0,5,0,0,2,2,0,0,0,0,0,0,0
"kaggle:titanic","cases",23,21,20,4,17,14,3,1,0,3,13,2,7,1,6,0,1,0
"kaggle:titanic","noNA.levels",22,6,6,3,3,3,1,2,0,0,1,2,5,2,3,0,2,0
"kaggle:titanic","apply",375,160,156,64,96,73,42,22,0,23,85,7,59,22,37,2,20,0
"kaggle:titanic","id_var",35,19,19,6,13,12,6,0,0,1,11,2,8,0,8,0,0,0
"kaggle:titanic","id",110,61,60,17,44,33,14,3,0,11,34,8,14,4,10,2,2,0
"kaggle:titanic","modify_list",16,14,14,7,7,7,0,7,0,0,6,1,6,1,5,0,1,0
"kaggle:titanic","apply_fun",65,40,40,7,33,30,5,2,0,3,30,3,4,1,3,1,0,0
"kaggle:titanic","FUN",23,7,7,1,6,5,1,0,0,1,5,1,0,0,0,0,0,0
"kaggle:titanic","%||%",3,3,2,0,3,2,0,0,0,1,3,0,3,0,3,0,0,0
"kaggle:titanic","expand_limits_scale",65,50,50,3,47,41,3,0,0,6,39,5,12,0,12,0,0,0
"kaggle:titanic","new.env",4,4,3,3,1,0,1,2,0,1,0,0,2,2,0,0,2,0
"kaggle:titanic","ggproto",65,25,24,6,19,15,4,2,0,4,14,4,8,3,5,1,2,0
"kaggle:titanic","censor",32,20,20,9,11,10,8,1,0,1,9,1,3,2,1,2,0,0
"kaggle:titanic","view_scale_primary",66,28,28,1,27,27,1,0,0,0,23,4,1,0,1,0,0,0
"kaggle:titanic","",25,17,17,3,14,12,2,1,0,2,11,3,0,0,0,0,0,0
"kaggle:titanic","unknown--fromOverride",487,136,136,58,78,64,42,16,0,14,75,1,24,12,12,0,12,0
"kaggle:titanic","",551,394,392,110,284,222,97,11,2,62,280,3,4,0,4,0,0,0
"kaggle:titanic","seq",1,0,0,0,0,0,0,0,0,0,0,0,0,0,0,0,0,0
"kaggle:titanic","",160,75,74,19,56,47,16,3,0,9,50,6,2,1,1,0,1,0
"kaggle:titanic","oob_squish",36,24,24,3,21,9,3,0,0,12,19,0,1,0,1,0,0,0
"kaggle:titanic","discard",31,13,13,2,11,7,2,0,0,4,10,0,1,0,1,0,0,0
"kaggle:titanic","",3,3,3,0,3,3,0,0,0,0,2,1,0,0,0,0,0,0
"kaggle:titanic","%|W|%",9,9,9,2,7,5,2,0,0,2,2,3,6,0,6,0,0,0
"kaggle:titanic","FUN",10,6,6,0,6,5,0,0,0,1,5,1,3,0,3,0,0,0
"kaggle:titanic","coord_munch",147,8,8,1,7,7,1,0,0,0,6,1,0,0,0,0,0,0
"kaggle:titanic","intersect",13,9,9,0,9,9,0,0,0,0,8,1,0,0,0,0,0,0
"kaggle:titanic","FUN",36,11,10,3,8,5,2,1,0,3,3,3,2,0,2,0,0,0
"kaggle:titanic","defer",68,40,38,8,32,21,7,1,0,11,24,6,5,1,4,1,0,0
"kaggle:titanic","split",1,0,0,0,0,0,0,0,0,0,0,0,0,0,0,0,0,0
"kaggle:titanic","make_proto_method",33,23,22,4,19,16,3,1,0,3,9,8,8,1,7,1,0,0
"kaggle:titanic","check_linewidth",17,3,3,0,3,3,0,0,0,0,2,1,1,0,1,0,0,0
"kaggle:titanic","break_positions_minor",10,8,8,0,8,7,0,0,0,1,8,0,0,0,0,0,0,0
"kaggle:titanic","get_breaks_minor",3,2,2,0,2,2,0,0,0,0,0,2,0,0,0,0,0,0
"kaggle:titanic","break_positions",8,6,6,0,6,6,0,0,0,0,4,2,2,0,2,0,0,0
"kaggle:titanic","panel_guides_grob",30,18,18,2,16,14,2,0,0,2,11,3,2,0,2,0,0,0
"kaggle:titanic","gtable_width",7,3,3,0,3,3,0,0,0,0,0,3,2,0,2,0,0,0
"kaggle:titanic","gtable_height",7,3,3,0,3,3,0,0,0,0,0,3,2,0,2,0,0,0
"kaggle:titanic","new_data_frame",22,16,11,3,13,6,2,1,0,7,8,2,3,1,2,0,1,0
"kaggle:titanic","add_theme",49,40,40,4,36,36,4,0,0,0,35,1,2,0,2,0,0,0
"kaggle:titanic","is_theme_validate",20,16,16,1,15,2,1,0,0,13,11,1,5,0,5,0,0,0
"kaggle:titanic","widthDetails",2,0,0,0,0,0,0,0,0,0,0,0,0,0,0,0,0,0
"kaggle:titanic","convertWidth",4,4,4,0,4,4,0,0,0,0,0,4,2,0,2,0,0,0
"kaggle:titanic","element_render",22,12,12,0,12,11,0,0,0,1,10,2,0,0,0,0,0,0
"kaggle:titanic","calc_element",99,51,51,5,46,42,4,1,0,4,39,6,13,1,12,0,1,0
"kaggle:titanic","FUN",29,25,25,6,19,17,6,0,0,2,5,12,9,0,9,0,0,0
"kaggle:titanic","calc_element",99,51,51,5,46,42,4,1,0,4,39,6,13,1,12,0,1,0
"kaggle:titanic","FUN",64,48,47,9,39,35,3,6,0,4,29,8,6,0,6,0,0,0
"kaggle:titanic","setup_elements",19,17,17,3,14,14,1,2,0,0,10,4,0,0,0,0,0,0
"kaggle:titanic","is_theme_validate",20,16,16,1,15,2,1,0,0,13,11,1,5,0,5,0,0,0
"kaggle:titanic","width_cm",29,25,25,5,20,18,5,0,0,2,7,11,12,0,12,0,0,0
"kaggle:titanic","element_grob",1,0,0,0,0,0,0,0,0,0,0,0,0,0,0,0,0,0
"kaggle:titanic","gtable_add_rows",117,38,36,5,33,29,5,0,0,4,20,10,8,0,8,0,0,0
"kaggle:titanic","gtable_add_cols",117,38,36,4,34,30,4,0,0,4,20,11,9,0,9,0,0,0
"kaggle:titanic","",1,1,1,0,1,1,0,0,0,0,0,1,0,0,0,0,0,0
"kaggle:titanic","FUN",11,4,4,1,3,3,1,0,0,0,1,2,0,0,0,0,0,0
"kaggle:titanic","array",53,14,14,7,7,4,1,6,0,3,7,0,7,6,1,1,5,0
"kaggle:titanic","as.graphicsAnnot",10,5,5,1,4,1,1,0,0,3,4,0,3,1,2,1,0,0
"kaggle:titanic","rownames",28,16,16,6,10,7,4,2,0,3,4,4,7,2,5,0,2,0
"kaggle:titanic","reformulate",29,16,16,4,12,12,2,2,0,0,10,2,0,0,0,0,0,0
"kaggle:titanic","is.ordered",5,5,5,1,4,2,1,0,0,2,0,2,3,0,3,0,0,0
"kaggle:titanic","FUN",4,4,4,1,3,3,1,0,0,0,0,3,1,0,1,0,0,0
"kaggle:titanic","double",1,1,1,1,0,0,0,1,0,0,0,0,1,1,0,0,1,0
"kaggle:titanic","FUN",6,5,5,1,4,4,0,1,0,0,2,2,0,0,0,0,0,0
"kaggle:titanic","is_call",11,6,6,1,5,5,1,0,0,0,2,3,4,0,4,0,0,0
"kaggle:titanic","arg_match0",12,5,5,0,5,5,0,0,0,0,2,3,1,0,1,0,0,0
"kaggle:titanic","node_car",5,3,3,0,3,3,0,0,0,0,0,3,1,0,1,0,0,0
"kaggle:titanic","every",95,32,32,5,27,27,5,0,0,0,23,4,9,0,9,0,0,0
"kaggle:titanic","quo_is_symbolic",5,3,3,1,2,2,1,0,0,0,0,2,0,0,0,0,0,0
"kaggle:titanic","fortify",1,0,0,0,0,0,0,0,0,0,0,0,0,0,0,0,0,0
"kaggle:titanic","is_scalar_character",9,6,6,2,4,4,2,0,0,0,0,4,2,0,2,0,0,0
"kaggle:titanic","unknown--fromConstant",40,13,13,3,10,10,1,2,0,0,10,0,3,0,3,0,0,0
"kaggle:titanic","camelize",15,15,13,0,15,13,0,0,0,2,11,2,1,0,1,0,0,0
"kaggle:titanic","to_upper_ascii",13,9,9,0,9,9,0,0,0,0,8,1,0,0,0,0,0,0
"kaggle:titanic","substring",38,23,23,11,12,10,4,7,0,2,10,2,11,7,4,0,7,0
"kaggle:titanic","FUN",38,29,29,8,21,19,8,0,0,2,6,13,13,1,12,1,0,0
"kaggle:titanic","FUN",1,0,0,0,0,0,0,0,0,0,0,0,0,0,0,0,0,0
"kaggle:titanic","check_breaks_labels",20,5,5,1,4,2,1,0,0,2,3,1,1,0,1,0,0,0
"kaggle:titanic","get_inherit",3,3,3,0,3,3,0,0,0,0,0,3,0,0,0,0,0,0
"kaggle:titanic","paste",4,4,4,4,0,0,1,3,0,0,0,0,2,2,0,0,2,0
"kaggle:titanic","scale_type",1,0,0,0,0,0,0,0,0,0,0,0,0,0,0,0,0,0
"kaggle:titanic","find_global",17,8,8,1,7,7,1,0,0,0,6,1,1,0,1,0,0,0
"kaggle:titanic","find_scale",52,27,27,4,23,19,4,0,0,4,15,6,8,0,8,0,0,0
"kaggle:titanic","current_call",29,16,15,1,15,14,1,0,0,1,10,5,1,0,1,0,0,0
"kaggle:titanic","new_continuous_palette",32,12,11,2,10,9,2,0,0,1,3,6,1,0,1,0,0,0
"kaggle:titanic","vapply",17,11,10,0,11,9,0,0,0,2,6,3,7,0,7,0,0,0
"kaggle:titanic","check_nondata_cols",23,11,10,3,8,7,2,1,0,1,4,3,2,0,2,0,0,0
"kaggle:titanic","scale_type",1,0,0,0,0,0,0,0,0,0,0,0,0,0,0,0,0,0
"kaggle:titanic","FUN",14,8,8,3,5,4,2,1,0,1,3,2,3,0,3,0,0,0
"kaggle:titanic","scale_apply",50,35,33,7,28,25,5,2,0,3,18,10,6,1,5,0,1,0
"kaggle:titanic","quo_squash_impl",29,23,23,2,21,14,2,0,0,7,17,4,8,0,8,0,0,0
"kaggle:titanic","as_label",94,54,52,7,47,35,7,0,0,12,28,15,18,0,18,0,0,0
"kaggle:titanic","strip_dots",106,59,56,12,47,41,7,5,0,6,35,8,17,2,15,0,2,0
"kaggle:titanic","rep_len",2,2,2,2,0,0,0,2,0,0,0,0,2,2,0,0,2,0
"kaggle:titanic","new_mapped_discrete",8,4,4,0,4,4,0,0,0,0,3,1,0,0,0,0,0,0
"kaggle:titanic","vec_slice",10,5,5,0,5,4,0,0,0,1,2,3,2,0,2,0,0,0
"kaggle:titanic","eval_bare",8,5,5,0,5,4,0,0,0,1,2,2,1,0,1,0,0,0
"kaggle:titanic","slot<-",14,6,6,0,6,6,0,0,0,0,2,4,1,0,1,0,0,0
"kaggle:titanic",".simpleInheritanceGeneric",13,11,11,1,10,3,1,0,0,7,8,2,4,0,4,0,0,0
"kaggle:titanic","is_discrete",0,0,0,0,0,0,0,0,0,0,0,0,0,0,0,0,0,0
"kaggle:titanic","is_empty",13,3,3,0,3,3,0,0,0,0,2,1,0,0,0,0,0,0
"kaggle:titanic","expand_limits_discrete_trans",155,71,60,19,52,47,18,1,0,5,48,4,2,0,2,0,0,0
"kaggle:titanic","view_scale_primary",66,28,28,1,27,27,1,0,0,0,23,4,1,0,1,0,0,0
"kaggle:titanic","view_scale_secondary",156,45,44,3,42,39,3,0,0,3,29,10,6,0,6,0,0,0
"kaggle:titanic","expand_limits_discrete",10,7,7,0,7,7,0,0,0,0,6,1,0,0,0,0,0,0
"kaggle:titanic","expand_limits_scale",64,49,46,3,46,41,3,0,0,5,39,5,11,0,11,0,0,0
"kaggle:titanic","view_scales_from_scale",76,56,54,8,48,44,4,4,0,4,35,9,11,0,11,0,0,0
"kaggle:titanic","force",1,1,1,0,1,1,0,0,0,0,0,1,1,0,1,0,0,0
"kaggle:titanic",".doSortWrap",40,22,22,8,14,11,6,2,0,3,10,2,8,2,6,1,1,0
"kaggle:titanic","",12,12,12,2,10,8,2,0,0,2,4,4,6,0,6,0,0,0
"kaggle:titanic","",16,15,15,2,13,11,2,0,0,2,5,6,6,0,6,0,0,0
"kaggle:titanic","is_discrete",3,2,2,1,1,1,1,0,0,0,0,1,0,0,0,0,0,0
"kaggle:titanic","extract_params",11,1,1,0,1,1,0,0,0,0,0,1,0,0,0,0,0,0
"kaggle:titanic","",20,16,16,0,16,15,0,0,0,1,16,0,0,0,0,0,0,0
"kaggle:titanic","get_layer_key",1,1,1,0,1,1,0,0,0,0,0,1,0,0,0,0,0,0
"kaggle:titanic","oob_censor_any",35,20,16,3,17,10,3,0,0,7,17,0,0,0,0,0,0,0
"kaggle:titanic","make_title",1,1,1,1,0,0,0,1,0,0,0,0,0,0,0,0,0,0
"kaggle:titanic","rescale",1,0,0,0,0,0,0,0,0,0,0,0,0,0,0,0,0,0
"kaggle:titanic","l_interp",28,19,19,0,19,19,0,0,0,0,14,5,0,0,0,0,0,0
"kaggle:titanic","ggproto_parent",59,30,28,8,22,19,4,4,0,3,19,3,6,2,4,0,2,0
"kaggle:titanic","vec_any_missing",5,3,3,1,2,2,1,0,0,0,0,2,0,0,0,0,0,0
"kaggle:titanic","vec_interleave_indices",7,4,4,0,4,4,0,0,0,0,2,2,0,0,0,0,0,0
"kaggle:titanic","draw_axis_labels",36,14,14,2,12,12,2,0,0,0,7,5,3,0,3,0,0,0
"kaggle:titanic","setup_params",62,42,42,14,28,25,5,9,0,3,26,1,4,1,3,1,0,0
"kaggle:titanic","setup_elements",33,28,28,3,25,23,1,2,0,2,19,6,3,0,3,0,0,0
"kaggle:titanic","element_text",118,60,58,23,37,32,12,11,0,5,31,5,24,9,15,0,9,0
"kaggle:titanic","override_elements",142,17,17,3,14,12,3,0,0,2,10,2,3,0,3,0,0,0
"kaggle:titanic","build_title",2,2,2,0,2,1,0,0,0,1,0,1,0,0,0,0,0,0
"kaggle:titanic","build_ticks",48,20,20,1,19,19,1,0,0,0,15,4,0,0,0,0,0,0
"kaggle:titanic","is_theme_element",18,16,15,4,12,7,4,0,0,5,8,2,5,0,5,0,0,0
"kaggle:titanic","element_grob",1,0,0,0,0,0,0,0,0,0,0,0,0,0,0,0,0,0
"kaggle:titanic","build_ticks",120,70,69,8,62,57,8,0,0,5,47,13,15,1,14,1,0,0
"kaggle:titanic","build_labels",80,43,43,6,37,31,5,1,0,6,25,10,14,1,13,1,0,0
"kaggle:titanic","FUN",19,15,15,0,15,15,0,0,0,0,15,0,2,0,2,0,0,0
"kaggle:titanic","structure",55,26,23,8,18,15,4,4,0,3,17,1,6,2,4,0,2,0
"kaggle:titanic","convertUnit",49,46,46,8,38,38,8,0,0,0,34,4,6,1,5,1,0,0
"kaggle:titanic","measure_grobs",121,79,77,4,75,72,4,0,0,3,62,13,6,0,6,0,0,0
"kaggle:titanic","arrange_layout",27,21,21,4,17,15,4,0,0,2,15,2,0,0,0,0,0,0
"kaggle:titanic","assemble_drawing",138,68,67,3,65,64,1,2,0,1,56,9,16,0,16,0,0,0
"kaggle:titanic","setNames",4,3,3,0,3,3,0,0,0,0,2,1,0,0,0,0,0,0
"kaggle:titanic","grobHeight",1,0,0,0,0,0,0,0,0,0,0,0,0,0,0,0,0,0
"kaggle:titanic","ifelse",105,59,58,25,34,25,14,11,0,9,28,4,29,16,13,8,8,0
"kaggle:titanic","unitType",68,21,21,5,16,14,2,3,0,2,11,3,5,2,3,0,2,0
"kaggle:titanic","validate_labels",16,2,2,1,1,0,0,1,0,1,1,0,0,0,0,0,0,0
"kaggle:titanic","%||%",3,3,3,0,3,2,0,0,0,1,3,0,3,0,3,0,0,0
"kaggle:titanic","apply",375,193,189,74,119,92,47,27,0,27,108,7,61,22,39,2,20,0
"kaggle:titanic","array",53,14,10,6,8,2,1,5,0,6,8,0,7,5,2,1,4,0
"kaggle:titanic","gtable_add_rows",117,38,36,5,33,29,5,0,0,4,20,10,8,0,8,0,0,0
"kaggle:titanic","gtable_add_rows",117,38,36,5,33,29,5,0,0,4,20,10,8,0,8,0,0,0
"kaggle:titanic","gtable_add_cols",117,38,36,4,34,30,4,0,0,4,20,11,9,0,9,0,0,0
"kaggle:titanic","gtable_add_padding",19,18,18,0,18,17,0,0,0,1,18,0,0,0,0,0,0,0
"kaggle:titanic","package_box",368,159,98,12,147,35,7,5,0,112,132,3,11,0,11,0,0,0
"kaggle:titanic","FUN",9,7,7,2,5,3,2,0,0,2,0,3,2,0,2,0,0,0
"kaggle:titanic","FUN",11,7,7,4,3,3,3,1,0,0,3,0,3,1,2,0,1,0
"kaggle:titanic","FUN",14,10,10,4,6,4,4,0,0,2,2,2,5,0,5,0,0,0
"kaggle:titanic","FUN",14,12,12,5,7,5,4,1,0,2,2,3,4,0,4,0,0,0
"kaggle:titanic","matrix",13,11,7,0,11,3,0,0,0,8,8,2,6,0,6,0,0,0
"RealThing:volcano","match",4,4,4,2,2,1,0,2,0,1,0,1,2,2,0,0,2,0
"RealThing:volcano","%in%",8,8,8,2,6,3,1,1,0,3,0,3,4,1,3,0,1,0
"RealThing:volcano","unknown--fromConstant",4,3,3,2,1,1,2,0,0,0,0,1,0,0,0,0,0,0
"RealThing:volcano","unknown--fromConstant",4,3,3,2,1,1,2,0,0,0,0,1,0,0,0,0,0,0
"RealThing:volcano","bilinear",105,85,85,10,75,26,9,1,0,49,72,1,0,0,0,0,0,0
"RealThing:volcano","match.fun",40,3,3,1,2,1,0,1,0,1,1,1,0,0,0,0,0,0
"RealThing:volcano","is.logint",9,4,4,0,4,1,0,0,0,3,4,0,0,0,0,0,0,0
"RealThing:volcano","lapply",17,13,12,0,13,11,0,0,0,2,10,1,7,0,7,0,0,0
"RealThing:volcano","isFALSE",11,8,7,1,7,1,1,0,0,6,6,0,0,0,0,0,0,0
"RealThing:volcano","unlist",27,5,5,0,5,5,0,0,0,0,5,0,0,0,0,0,0,0
"RealThing:volcano","sapply",32,20,19,4,16,12,4,0,0,4,15,0,0,0,0,0,0,0
"RealThing:volcano","bilinear",105,85,85,12,73,24,11,1,0,49,70,1,0,0,0,0,0,0
"RealThing:volcano","bench_rays",1448,212,202,67,145,74,63,4,0,71,141,3,4,0,4,0,0,0
"RealThing:volcano","unknown--fromConstant",4,3,3,1,2,2,1,0,0,0,0,2,0,0,0,0,0,0
"RealThing:volcano","simplify2array",151,23,22,8,15,10,7,1,0,5,14,1,0,0,0,0,0,0
"RealThing:volcano","unique",1,0,0,0,0,0,0,0,0,0,0,0,0,0,0,0,0,0
"RealThing:volcano","unknown--fromConstant",2,2,2,1,1,1,0,1,0,0,0,1,0,0,0,0,0,0
"RealThing:volcano","chkDots",15,1,1,1,0,0,1,0,0,0,0,0,0,0,0,0,0,0
"RealThing:volcano","as.vector",2,2,2,1,1,0,1,0,0,1,0,0,0,0,0,0,0,0
"RealThing:volcano","Sys.time",8,5,5,0,5,5,0,0,0,0,2,3,0,0,0,0,0,0
"RealThing:volcano","execute",39,18,17,4,14,12,4,0,0,2,14,0,0,0,0,0,0,0
"RealThing:volcano","print",1,0,0,0,0,0,0,0,0,0,0,0,0,0,0,0,0,0
"RealThing:volcano","stdout",0,0,0,0,0,0,0,0,0,0,0,0,0,0,0,0,0,0
